شخص ما يحمل لوح التزلج ليلا على الرصيف.	رجل جالس بمفرده يقرأ على طاولة مستديرة ، خارج أحد المتاجر.
تتسابق النساء في سباق الدايتونا 500.	يتسابق بعض الرجال ضمن مسابقة التزلج.
تمشي النساء جنبا إلى جنب.	هناك فتيات يمشين متجاورات
يقفز الرجل ذو القميص الأخضر عاليا على العشب.	يمشي الرجل ذو القميص الأبيض على العشب الطويل ممسكا بعصا.
رجلان يجلسان على العشب ومعهما موز.	ثلاثة رجال يتسكعون عند فرشة بيع الفاكهة.
كومة من الصخور تحمل علامات غريبة ، تسببت في تجمع الناس حولها.	يسير بعض الأشخاص على بعض الصخور الموجودة في الماء.
ساعدت النساء أحد العدائين الذي كان قد سقط ، للوقوف ثانية على قدميه.	كانت المرأة تضع المكياج.
تشتري المرأة الغَزْل.	تبيع إحدى النساء المحصول.
تهرول امرأة في أحد الأزقة ، مرتدية ملابس سوداء .	يسير شاب ذو سترة سوداء على الرصيف.
إنه حفل موسيقي.	يقدم شخصٌ حفلا موسيقيا.
ذهب الرجلان إلى المدرسة معا.	يذهب رجلان إلى العمل.
تحتوي حقيبة المرأة على المعرض الفني الذي تتواجد فيه.	تحمل المرأة عملا فنيا في المدرسة.
يقف ثلاثة أشخاص على منصة سوداء صلبة بجانب كرسي أسود وقيثارة.	تقف امرأة تعزف القيثارة على كرسي أمام البيت الأبيض.
حقيبة الظهر واسعة من الداخل.	تقبع المرأة داخل غرفة الملابس الموجودة في اليخت.
فنان يحاول بيع لوحاته.	فنان يظهر لوحاته للآخرين.
رجل يتحدث إلى ثلاثة رجال عن امرأة تبدو غريبة الأطوار على اليسار 	تتحدث امرأتان إلى بعضهما البعض ، بينما ينظر رجل إليهما.
يراقب رجلان مرتديان ملابس داكنة اللون ، حشدا من الناس.	هناك أشخاص يرتدون ملابس بيضاء يحدقون في الخيول.
كان الرجل يقرع الطبول.	يحمل الرجل قيثارته.
الأرض عليها ثلوج.	ثلوج على الأرض.
 طول الصخرة قابل للتسلق.	الصخرة أطول من الرجل.
يقرأ طفل كتابا عن الكلاب.	كلب يقرأ كتابا للطفل.
هناك عرض عسكري في الخلاء.	هناك حشد يشاهد معرضا.
ترتدي لاعبة التنس زيا متناقض الألوان.	لاعبة تنس ترتدي ملابس باللون البرتقالي في منتصف مباراة لكرة المضرب.
يقوم الرجلان بتفحص حشرات نادرة في الأدغال.	يوجد كلبان في الثلوج ، وفي فمم أحدهما شيء
قد يكون لاعب الجمباز مناسبا.	سيذهب رجل للسباحةحالا.
قطة تطارد كلبا في الخارج.	يحاول كلب الإمساك بقطة.
تركض مجموعة من كلاب الزلاجات في السباق.	يسحب كلبان زلاجة في أحد السباقات.
يعمل كهربائي لتثبيت الأسلاك على قطب في السطح.	استقل رجل المصعد إلى السطح.
الفتاة في القسم الثاني تركض مبتسمة ، بينما تحمل منشفة أخواتها.	فتاة صغيرة تلعب مع صديقها لعبة الملابس التنكرية في الشرفة.
حطم رجل دراجتهم.	رجل يقود إحدى السيارات ، بينما ينظر إلى شاحنة.
أطفال يلعبون بالبالونات ،يجلس فوقه رجل يرتدي زي الموز.	امرأة ترتدي ملابس وردية وسوداء لديها وشم كبير على ظهرها.
يسير جنود أمام فيل	رقيب يقود قواته في تشكيل داخل غرفة كبيرة مع الكثير من الأعلام في الخلفية.
فتاة لديها كاحلان مكسوران.	الفتاة بدون أرجل.
تجلس امرأة مرتدية قميصا أبيض في حديقة محاطة بالملصقات.	يجلس رجل مرتديا لباسا أسود على مقعد في الحديقة بجانب لوحة كبيرة.
تصور رسومات على الحائط أطفالا يرسمون الكلمات " Brick City " على الحائط.	رسم بعض الفنون على أحد الجدران.
يرسم الرسام على الملابس	ملابس الطفل بها لون أبيض.
يحضر رجال من الشرق الأوسط السمك في مطبخ.	 امرأتان في مطبخ تحضران الخضار في مقلاة.
يلعب كلب بلعبته.	يلعب كلب بلعبته.
تحمل الفتاة جعة.	تحمل المرأة جعة.
يقطع رجل شيئا ما بسكين.	يفرم رجل شيئا ما على الطاولة بالسكين.
سبعة رجال يؤدون الصلاة في كنيسة.	شخصان يصليان خارج المعبد.
الرجل بالقرب من طفلين.	الصبي بالقرب من أطفال آخرين.
يرتدي الصبي قميصا أحمر.	يرتدي الصبي قميصا أصفر.
يسير صبيان ضمن موكب.	يسير الموسيقيون ضمن موكب.
امرأة جالسة على الشاطئ.	تجلس امرأة على الشاطئ.
أطفال يلعبون في الخارج.	أطفال يلعبون في الخارج.
كان الطفل يبكي لأنه كان جائعا.	لا يبكي الطفل.
الكلب يعرج وسط الحقل.	يركض الكلب في الحقل.
يجلس شخصان بجانب مبنى كبير، حيث كانا يتحدثان.	رجلان بجانب مبنى.
يقفز طفل مرتديا أحمر على شيء أحمر ، بينما يضحك الآخرون.	يبدأ رجل بدون قميص بالقفز من جانب الطبل وسط مجموعة من الطبول الأخرى.
لا يوجد امرأة في الشارع ترتدي الأخضر.	يمشي الرجل على الشارع مرتديا سترة بيضاء.
يحمل الرجلان شعارا موجها إلى الرئيس.	يقف ثلاثة رجال أمام إشارة عليها العلم الأمريكي.
يتواجد عامل صخور في أحد المطارات.	يتواجد رجل في إحدى المحطات.
الطفل يتعرق على الشاطئ.	الطفل على الشاطئ.
الناس نائمون على الأريكة.	الناس نيام على الأريكة.
كلب رمادي يركض في الخارج.	كلب أبيض يركض في الخارج.
امرأة مرتدية معطفا شتويا.	امرأة مرتدية معطفا كبيرا.
تمسك امرأة بيد طفلها.	تمسك فتاة بيد أمها.
أناس يلتقطون صورا لأحد الفيلة.	مجموعة من الناس يلتقطون صورا.
سائق الدراجة بعد السباق.	يفوز في السباق شخص على دراجة BMX 
الحقيبة الصفراء فارغة.	الحقيبة صفراء.
شاب لديه كعك.	تعد امرأة فطورا لها ولصديقها.
تجتمع الحشود في ساحة التايمز.	يجتمع حشد من الناس في ساحة التايمز.
كلب بردان في أحد البرك.	كلب ينفض الماء بعد السباحة في البركة.
تقف مجموعة من الناس ، أغلبهم بقبعات مصنوعة من القش ، في الخلاء بين الأراضي الخضراء.	تقف مجموعة من الناس ، أغلبهم بقبعات مصنوعة من القش ، في الخلاء بين الأراضي الخضراء.
يُعد النادل شرابا.	يقطع رجل شيئا ما في المطبخ.
كلبان يطاردان أرنبا.	قطتان تطاردان أرنبا.
يحلق الكلب عبر الهواء في الطائرة.	يحلق الكلب في الهواء.
تخيط امرأة القطعة الممزقة.	تستخدم امرأة آلة للخياطة.
يتسوق الناس لعيد الميلاد من أجل زملائهم العمال.	يتسوق الناس لشراء هدايا لعيد الميلاد.
يستلقي صبي صغير مرتديا قبعة صغيرة على عشب أخضر ، مع أوراق يابسة على الأرض ، على وشك أن يأخذ قيلولة.	فتاتان صغيرتان تأكلان الذرة على ظهر جواد قصير الأرجل ،على الرصيف ، بدون أحذية.
يتسوق الناس في الهواء الطلق.	الناس يتسوقون.
يعزف على آلة التوبا رجل يرتدي سترة جلدية.	يعزف على آلة السكسيفون رجل يرتدي سترة حمراء في الخارج.
رجل يُخرج القمامة.	رجل يجمع كل القمامة.
رجل يستلقي على الأرض.	رجل يستلقي على الأرض في الخارج.
عدد من الأشخاص تحت الأمطار.	الناس تحت المطر.
تؤدي الفرقة 8 أغنيات تحت الأضواء.	الفرقة تعزف تحت الأضواء.
يشاهد المتفرجون المسرحية التي تُعرض.	تحصل الجوقة على صورها التي تم التقاطها خلال العرض.
العجينة بيضاء.	الطاولة سميكة.
صبية يلعبون لعبة فيديو.	صبيان يلعبان لعبة فيديو.
طفل داخل نفق للسكك الحديدية.	رجل يعبر جسرا مهجورا أمام أحد الأبنية.
يتنافس مجموعة من الناس في نوع من مسابقات العدو.	هناك مجموعة من الناس في مسابقة.
تطبق فتاة صغيرة دروس الكاراتيه على أخيها.	فتاة تشاهد صديقها يمارس فنون الدفاع عن النفس.
يصافح الصبي رجل البلدية.	لا يرتدي الصبي شيئا على رأسه.
الرجل على الشاطئ.	الرجل على الشاطئ.
قفز الكلب عاليا.	يقفز كلب عاليا ، حين يكون بالخارج.
ذات مرة بين البرقوق الأزرق.	يستلقي جرو بني على ظهره فوق العشب.
رجل مسن يمسك شيئا حادا بين يديه.	رجل معه شيء ما بيده.
يقف أناس أمام معدات ميكانيكية.	هناك أشخاص يقفون أمام معدات ميكانيكية.
يركض كلبان باتجاه صاحبهما.	يركض كلبان إلى صاحبهما.
شقيقان يتناولان الطعام.	أشخاص يسرقون الطعام من بائع المواد الغذائية المتجول.
لاعب البيسبول أبيض اللون.	هناك لاعب بيسبول يرتدي اللون الأبيض.
يسحب الرجل مسدسا لسرقة فرشة البائع.	يحاول رجل إخماد حريق صغير.
يشاهد الناس عرضا محترفا للعب بالنار.	بعض الأطفال يلعبون لعبة في الخارج.
فتاة ترتري الوردي تمتطي مهرا.	فتاة تمتطي مهرا.
شاب يقوم بعمل خدع من على دراجة.	صبي يقوم بعمل حيل الدراجة.
رجل يرتدي قبعة الاستحمام وملابس السباحة يقفزإلى البركة ، في حين ينظر إليه رجال آخرون.	عامل على السلم يرتدي خوذة فولاذية وسترة ، في حين يعمل رجال آخرون في الأسفل. 
شخص ما ذاهب للسباحة في المحيط.	شخص ما يسبح في المحيط.
الجو مشمس في الخارج.	الجو بارد في الخارج.
رجل وامرأة لا يستطيعان رؤية بعضهما البعض.	يبحث الرجل عن شخص ما. 
هناك رجل ينتظر في مترو الأنفاق.	رجل ينظر إلى ساعته أثناء انتظاره مترو الانفاق.
فقاعة هواء طولها 20 قدما.	متسلق يتسلق في الظلام.
رجل عارٍ يجلس على الأريكة.	رجل يجلس على الأريكة.
رجل ينحت منحوتة من الجليد.	رجل يصنع أشكالا فنية من الجليد
النار جزء من العرض لعارض الشوارع.	الشخص يعرض في الشارع.
يتقافز الأطفال على الشاطئ وهم يبحثون عن المحار.	ثلاثة أطفال ينظرون إلى الأسماك النافقة الطافية فوق مياه المحيط.
رجل ذو سترة جلدية سوداء في فيلم	رجل ذو سترة جلدية سوداء.
رجل لم يكن يرتدي قميصا ولكنه كان يرتدي سروالا من الجينز.	كان الرجل يرتدي السراويل.
يجلس رجل عجوز.	رجل عجوز جالس
صبي معجب بدراجة.	شخص يسير الكلب، والطفل يركب لوح التزلج.
بعض الناس كانوا يمارسون الرياضة، وأصيب رجل واحد.	مجموعة رجال من الأصدقاء المقربين ، لديهم مباراة ليلية.
سيدة تقف على أكتاف رجل طويل القامة.	رجل يتحدث أمام سيدة تجلس وراء طاولة .
رجل يراقب رجلا آخر وهو يلعب لعبة.	طفل يلعب في بسيارة ويجيلز، ورجل يراقبه .
طفل يرتدي قميصا مقلما بقوس قزح يدفع عربة لعبة.	فتاة بقميص مقلم تجلس على دراجة هوائية.
لم يكن هناك دراجة	لا أحد على دراجة.
تستعد مجموعة من الناس للسباحة.	مجموعة من الناس تستعد للسباحة.
زوجان في باريس.	الرجلان والمرأة كانوا يتسوقون من أجل العشاء
شخص مستلقٍ على جدار.	شخص مستلقٍ على الرصيف .
رجلان يلعبان ببنادق المسامير، ولكن بدون خشب .	تلعب امرأتان لعبة بالعصي وكرة صغيرة بيضاء .
يحرك الرجل الأريكة.	الرجل يتحرك
السياح في روما معجبون بنافورة تريفي.	يشاهد السياح في روما المنحوتات.
امرأة شقراء متظاهرة أمام مطار.	امرأة غير متكلفة.
هو يعمل مع موظف آخر.	 مدير يتحدث إلى أحد العاملين عنده .
 وقف الرجل بالقرب من لافتة نبراسكا.	الرجل بالقرب من المنشار.
صبي مراهق يقفزعلى مزلجة قابلة للنفخ.	صبي يثب على ترامبولين .
استمر شخص بلعب الحجلة لمدة 12 ساعة.	هناك أرض يأتي إليها جميع الأطفال ويجلسون على شكل حلقة قبل بداية المباراة
رجل يرتدي زي شبح ، يحب الموسيقى التي تعزف بعنف.	رجل يعزف على غيتاره، مرتديا زيا تقليديا.
صبي وبسعادة موازنة طبق من ذهب.	صبي هو يحقق توازن طبق من ذهب.
فتاة ترتدي ألوانا ترقص في الخارج .	فتاة صغيرة ترتدي ورديا ، ترقص على الرصيف.
عصفور يجلس على سلك الطاقة.	رجل بجوار إشارة المرور.
مجموعة من الأطفال يسبحون في مَسْبَح.	مجموعة من النساء تسبحن في مَسْبَح.
شخص يكتب شيئا ما على كتاب.	شخص ما يفتح كتابا.
رجل ما ينظيف النوافذ في الداخل.	ينام شخص ما على الأرض الطوبية.
تعقد البنات أصابعهن على شكل V.	رجل وامرأة يقفان بجوار شجرة عيد الميلاد وأيديهما على ذقونهما .
يهرب الناس من الأجانب.	الناس في الخارج يلوذون بالفرار .
يعزف الرجل لحشد من الناس .	امرأة تعزف لحشد من الناس .
صبي صغير يتسلق شجيرة في وسط المدينة.	فتاة تتأمل على قمة صخرة عالية في وسط غابة.
هذه المرأة تشاهد التلفاز ، بينما هي تنتظر الطعام.	عائلة تشاهد التلفاز معا.
مجموعة من الرجال يتحدثون .	الرجل موجود مع مجموعة من الأصدقاء
رجال يتناولون موضوعا ما .	شخصان ينقلان منصة إلى مكان جديد .
أطفال يرتدون ملابس متوافقة متواجدون في حفلة.	الرجال والنساء جميعهم يرتدون ملابس أنيقة لحفلة فاخرة .
كثير من الناس يسيرون في الشارع.	بعض الناس يسيرون في أحد شوارع المدينة.
امرأة تمشي بجوار بائع أغذية متجول في الشوارع	امرأة تسير بجانب مطعم يقدم الوجبات السريعة.
يجلس طفل على جدار حجري .	يجلس طفل على جدار حجري في فصل الخريف.
يطارد فأر عملاق امرأتين لعضهما .	دخلت امرأتان في معركة مع القط.
الشباب يلتقطون صورا من الجو .	هناك فتيات تلتقطن صورا.
طفلة ووالدها يلتقطان صورا أثناء تنزهما في الحديقة.	 اصطحبت طفلة بواسطة والدها إلى نزهة في حديقة .
سيارة البناء في الخارج.	يعمل طاقم البناء في الخارج .
يرتدي راكب الأمواج بدلة غواصين سوداء .	رجل في بذلة غواصين سوداء يركب الأمواج علي لوح ركوب أمواج أخضر.
الرجل في الخارج بجوار لافتة الحافلات .	تعبر امرأة الشارع ، رؤية الكاميرا هي من بين حافلتين.
يوجد كلب في الصورة.	هناك كلب في الصورة
صبيان يرتديان ملابس للسباحة	الفتيات ترتدين التنانير.
سيدة مسنة تدفع عربة	سيدة مسنة تدفع عربة أطفال.
رجل يعزف على بوق فرنسي لجذب الانتباه .	صبي بسترة يعزف على البوق الفرنسي.
يعزف الناس الموسيقى لاحتفال هذا الأسبوع .	يؤدي الناس العرض على خشبة المسرح.
عامل على الأرض ينظر إلى قاعدة الأساس.	عامل بالحديد يقف بجانب العلم في الجزء العلوي من المبنى الذي يعمل عليه .
رجل يقطع السمك .	رجل يقطع السمك
صبيان يمسكان بدراجة .	 بنتان على دراجة .
تلعب الكلاب في الهواء الطلق.	تلعب الحيوانات في الهواء الطلق.
تلعب قطتان في الماء.	تلعب الكلاب في الماء.
تأكل فتاة المعكرونة كلها ، ولا تبقي منها شيئا لصديقتها.	رجل وامرأة في المطبخ مع امرأة أخرى وهي تطهي  شيء للطعام.
هناك ذكر وأنثى بالداخل.	الذكر مع أنثى صغيرة.
مجموعة من الناس يقفون في أحد المخازن.	مجموعة مكونة من ثلاثة أشخاص يقفون أمام حوض أسماك فارغ ..
شاب يركب دراجة أحادية.	رجل يساعد فتاة صغيرة على ركوب دراجة.
هناك أشخاص بالقرب من كرة قدم.	بعض الأشخاص يقذفون كرة القدم نحو الشمس.
 وحش خرج من المحيط.	 صبي صغير يهرب بعيدا عن موجات المحيط المقتربة .
شابان يركبان الرمث أسفل النهر.	إنهم يجدفون أسفل نهر مفضل .
عمال يزيلون قمامة الشارع.	العمال خارج العمل في شارع غمرته المياه.
البنات والولد والخارج.	الصبي والفتاة يسيرون خارجا .
تمثال الطائر يحمل زهرة.	تمتثل المرأة أمام اثنين من تماثيل الفيلة الكبيرة في متحف.
شخصان بالغان يتقاتلان في الشارع بعد مباراة لكرة القدم.	الفتاتان في منتصف اللعبة.
راعي البقر على وشك أن يترنح من على الثور.	مهرج على وشك أن يتم دهسه من قبل ثور.
رجل يجلس على كرسي يقرأ كتابا .	رجل يجلس على كرسي يقرأ مجلة.
 طفل نائم في حين أن والدته تقوم بدفعه في عربة الأطفال.	طفل صغير يركض باتجاه أمه .
 مجموعة من الناس يذهبون للجري.	 مجموعة من الناس يتحدثون بجانب بعضهم البعض .
عمال المصنع يصنعون زجاجات	يعمل عمال المصانع بحزم الصفراء.
ثلاثة رجال يستعدون لسباق ماراثون.	رجلان يتدربان استعدادا لسباق مارثون
شخص يتعلم السباحة.	امرأة تتعلم كيفية السباحة.
الناس يسيرون كمجموعة في الخارج.	مجموعة من الناس يسيرون في الخلاء.
يركض كلبان خلف كرة في الخارج.	كلبان يجريان في الحقل وصحبهما يراقبها.
رجل جاء لتوه من البحر يرتدي بدلة الغوص والآن يحمل صندوق.	رجل بلا قميص وامرأة في بيكيني في الماء يشيحون بنظرهم بعيدا عن الكاميرا.
رجل آسيوي يشاهد حدثا ذا زخارف كثيرة في خلفيتها حروف صينية.	زوجان أسيويان يقفان إلى جانب ملصق خيالي.
كلب أسود يلعب بلعبة خضراء.	يلعب كلب أسود بلعبة حمراء.
جهاز الدي جي يعمل في النادي	جلب الدي جي الكثير من المال للنادي
ثلاثة أشخاص ينتظرون الناس بجوار جدار حجري.	شخصان يعملان علي جدار حجري
رجل يقظ تمامًا في القطار.	رجل على متن قطاريتطلع من النافذة.
هناك شخص يتعارك.	الرجل ليس بالقرب من أي أشخاص.
زوجان يلعبان كرة الماء في الأجازة.	يذهب الولد للسباحة عندما يكون في عطلة.
مرت السيارة بجوار الأشخاص مانعة عنهم المطر	نفثت سيارة سباق الدخان عندما اجتازت خط النهاية.
 طفلة تنظر لصورتها المنعكسة في بركة ماء.	فتاة تتمرن في الغرفة.
 الرجل يختبر الهدف في مسدسه الجديد.	رجل يقوم بخدعة على دراجة في الهواء.
طفلان يتأرجحان في ملعب مزدحم.	صبيان مراهقان يسيران معا على الرصيف في مدينة.
امرأة رسمت وجهها.	المرأة ترسم وجهها
كلب يتساءل أين رفيقة.	صبي صغير يبتسم لكلب يجري نحوه.
صبي يرتدي بدلة دافئة لونها أصفر في أسود يلعب مع كلب بني يرتدي طوق أحمر.	صبي صغير يرتدي سترة زرقاء وحمراء ينبش الأوراق.
تلعب النساء سباق التزلج وسقطت واحدة ترتدي الأصفر.	اثنين من الصبية يلعبون لعبة الحصان في فصل الصيف.
هناك رجل يتناول العشاء في أحد المطاعم.	يتناول زوجان العشاء في أحد المطاعم.
جمهرة في المسرح.	رجل يقف في طابور في صالة السينما.
نفض الحكم الغبار عن صفيحة الملعب لكي يراها بشكل أفضل.	 السيدات مستعدات لضرب الكرة فور وصولها.
فتاة تقوم بالشقلبة.	امرأة تقوم بالشقلبة على الترامبولين.
 الرجل ليس على دراجة نارية.	 الرجل على دراجة نارية.
مراهق ينام على حصيرة	فتاة تتخطى حبل.
عالم لا يوجد لديه مجهر لينظر إليه	هناك عالم ينظر من خلال مجهر.
 طفل صغير معجب بسيارة رياضية خضراء.	رجل في ثياب زرقاء على لوح التزلج.
العديد من الرجال والنساء يجتازون مزرعة.	 فتاتان تعدوان خلال العشب في الخريف.
الفتاة شاهدت السيارة.	تقيأت فتاة في السيارة.
سيبلغ الرجل سن 49 هذا العام.	هناك شخص واحد فقط في الصورة كلها.
 رجل يمسك بمزمار.	 رجل يمسك بمزمار.
 رجل يرتدي زي شخصية فيلم يحمل بندقية في بهو صالة السينما.	الرجل داخل صالة السينما.
كلب يجري ويمسك بالكرة	كلب يمسك بالكرة.
كلب يعدو للمنزل	عدو الكلب 
رجل مستلق على الشاطئ	امرأة مستلقية على الشاطئ.
شخصان بالغان وطفلان يجلسان على مقعد في حديقة بينما يقوم شخص ما بالتقاط صورة.	يتهامس طفلان في فصل بينما يرقبهما آخر .
امرأة أسيوية تبتسم لكاميرا	فتاة آسيوية صغيرة تتصتع وجها مضحكا لكاميرة التلفزيون.
 امرأة تكره السترة الرمادية.	امرأة ترتدي بنطال رمادي.
كلب يعدو عبر العشب.	كلب يعدو عبر العشب.
امرأة رجل انتهيا لتوهما من زفافهما	تستمتع المرأة بيومها في الخارج مع خيولها.
طفل مزعور يمتطي بعصبية حصان.	 امرأة تركب ثورا بينما ينتظر المهرجين بأناة.
امرأة ورجل صغير في الخارج مع حيوان.	ذكر وامرأة أنثى يعملون بجد.
رجل يركل رجل آخر.	رجل عجوز يغفو قليلا.
ثلاث فتيات يقومن بالشقبلة على الشاطئ.	الفتاتان الصغيرتان تقفزان على السرير.
رجلان يقرآن في القطار	امرأتان تقرآن في القطار
رجل يستخدم منشار في المعرض.	صبي في المعرض.
صبي يركب دراجة ركوب في الحديقة.	هناك فتاة تركب الدراجة عبر الحديقة.
امرأة تسفع على الشاطئ.	رجل يسفع على الشاطئ.
امرأة تغسل.	الرجل يغسل.
الطفل يساعد أمه.	الطفل يدخر مع صديقه.
صف من الأرجل والأحذية السوداء مع صبي يجلس في نهاية الصف.	رجل يرتدي قميصا رمادي يضع ذراعه على حائط بجوار رجلين في زي رسمي.
عامل يصلح دعامة المرفق.	شخص يقود سيارة.
النساء يجلسون.	كل النساء جالسات.
المراهقون على متن حافلة المدينة.	 شخصان في سيارة في أحد شوارع المدينة.
مجموعة من النساء يعرضون للجمهور.	النساء يعرضون للجمهور
الرجال مثلي الجنس	النساء هن
الرجل لديه وشاح أبيض وأسود حول رقبته ويرتدي قبعة سوداء.	رجل أسود يرتدي قميصا أسود، وقبعة سوداء، ونظارات شمسية يضع يده حول فمه.
الفرقة الموسيقية التي ترتدي زي أصفر وأخضر تسيرعلي أرض الملعب.	فرقة موسيقية في زي أحمر وأبيض.
الأصدقاء، يتمتعون معا بمشروب في الخارج.	زوجان يتحدثان وهما يتمتعان ببعض المشروبات.
رجل ينفخ في البوق في الفرقة الموسيقية.	رجل يقرع طبل في فرقة موسيقية.
العلماء يكرهون العلم	الطلاب يشاهدون تجربة علمية.
الطفل يطارد البط في الحديقة بسعادة.	الطفل يراقب البط في الحديقة.
راكب الدراجة النارية في متجر للدراجات.	دخل الرجل متجر للدراجات.
مدرسة ممتلئة بالأطفال.	حفنة من النساء في مكتبة مع الأطفال.
رجلان وامرأة يعملون في مقصورات.	هناك أربع نساء ورجل في المطبخ.
المرأة تعلم الفتاة الحياكة.	سوف تعلم المرأة الفتاة أن تنسج.
هناك زورق يقاوم في منطقة النهر المنحدرة بين صخرتين .	هناك زورق في منطقة النهر المنحدرة بين صخرتين .
غرفة زملاء الصف يشاهدون فيلما.	 طفل صغير يجلس في غرفته.
شاب يلعب بوحدة تحكم الألعاب العامة.	مجموعة من الاطفال يلعبون ألعاب الفيديو في منزل أحد الأصدقاء.
رجل يحاول التواصل.	رجل يحاول الوصول للعمل.
رجل يرتدي أصفر يتزلج قفزا فوق برميل.	 شخص على جبل معه طائرة شراعية خضراء.
بعض الناس لا يلوحون بأعلام.	الناس يلوحون.
عصا ممسوكة من قبل شخص ذي ملابس داكنة.	رجل يسير أمام منزل قديم غيرمطلي 
