La gente muestra su afecto el uno por el otro.	A women giving something to other lady.
Dos niños están bailando	Kids are dancing.
Dos pescadores caminando a trabajar por el muelle.	Two children play in the water by a pier and building.
La niña está intentando golpear una piñata.	A sad boy in a surfing shirt is swinging on a swing.
Un perro de rastreo está olfateando al grupo tratando de encontrar el olor del criminal.	The woman is sniffing the other.
Los ponis son amistosos.	The ponies are in love
Un gran grupo de atletas de triatlón están compitiendo en una carrera por las calles de la ciudad.	A group of outdoor enthusiasts are traveling as a group to their campsite up in the mountains.
Un grupo de personas está descansando cerca de colinas y acantilados.	A group of girls are overlooking the water.
Un adulto y un niño están arruinando sus uñas.	An adult and a child sitting down and both are biting their fingernails.
La gente está comprando verduras.	Some of the people are shopping for clothes.
Un hombre toca la guitarra mientras otro toca la batería en un escenario.	The man is playing a guitar while another plays the drums behind him.
El grupo de hombres compitió.	The group of men are from Chippendales.
Hay una multitud muy grande viendo la presentación	There is a crowd watching a performance.
Ellos están cantando también.	Two musicians are completely out of tune.
Hay una señora llevando a niños en sus dos manos.	The woman's hands are full with what she is carrying.
Mucha gente está descansando en la hierba.	The people are sleeping in the grass.
La mujer camina sola en la acera.	A woman walks on the sidewalk.
Un pianista y un cantante están listos para actuar.	The musician have a guitar and is waiting to perform.
Ellos están solos.	They are alone.
Un cigarrillo es luz.	A man is smoking a cigarette and holding a honeycomb.
Un niño está en un edificio de oficinas.	A child is in an office building.
Un mono come	the kid eats a frog
Un perro salta sobre los obstáculos para un show canino.	A dog jumps over something.
Un hombre está sosteniendo sombreros tratando de venderlos en la calle.	A man tries to sell something on the street.
Los árboles son todos exuberantes y verdes.	All of the trees are green with freshly bloomed leaves.
Una mujer mayor se sienta al lado de una niña pequeña que está usando un vestido de rayas.	A woman is dressed up.
Ellos están viendo a su equipo favorito jugar.	They are cheering for their favorite team.
Puedes ver más de un perro en la foto.	You can see that there is more than one animal in the shot.
Un hombre que lleva un casco montando su bicicleta por la calle.	A man is riding a blue bicycle helmet down a busy street.
Una mujer se sienta mientras toca una guitarra.	A woman is playing a piano.
Una mujer mira a otra persona.	A woman is looking at a person.
La policía está tratando de ayudar a la gente.	The people are trying to get home.
Un niño con un chupete en su boca está sentado en una maleta.	A child in a stroller with a pacifier in its mouth.
Hay personas participando en natación competitiva.	These people are swimming in a competition.
Un grupo de personas está sentado discutiendo algo.	There is a group of people standing around, looking like they are waiting for something.
Un grupo de personas posando fuera de un edificio para una sesión de fotos de una revista.	A group of people pose for a photograph.
Un grupo de tres jóvenes adultos se detuvo para posar para una foto fuera de una tienda de ropa.	The children are taking a picture outside.
Una chica corre por la calle.	A boy runs down the street.
Un hombre joven que gira un destornillador.	A young person turning a screwdriver.
Un niño está con su mascota.	A man holding a child and a baby.
Un hombre vuela sobre una alfombra.	Dogs pull a man on a sled down a hill.
La mujer está llorando mientras toca la guitarra.	The man is singing and the woman is playing guitar.
El niño salta al otro colchón.	The child is holding the toys up to his eyes.
Un muchacho sin camisa está tomando la siesta en la hierba.	A boy walking in the grass.
Un hombre duerme en su cama.	An old person sleeps in a bed.
El perro blanco está recibiendo un baño en los peluqueros caninos.	The white dog is taking a bath
Una mujer leyendo mientras espera un tren.	A man is reading while waiting for a bus.
Un hombre asiático de pie junto a una puerta apunta a algo.	A person stands with their back to us.
Una mujer y una jovencita están sentadas en una mesa en un restaurante.	a woman and a boy are sitting at a table
El hombre usa tanga y está de pie sobre el taburete.	A man wearing tan pants and blue shirt is sitting on a sidewalk resting.
Una niña está leyendo sobre trenes.	There is a girl reading.
Los animales están domesticados.	The dogs are reptiles.
Dos hombres están juntos preparándose para hacer gimnasia.	The men and women are going to perform.
Una persona está atándose el cabello en un bosque	A person is in the water and throwing their hair back.
La ventana es pequeña.	the room is large
Una niña está mojando a otra con su pistola de agua.	A girl is inside with her dog
Un grupo de excursionistas que visten de verde, rojo y negro de pie en la suciedad en un área boscosa	Two brown and white dogs fighting on a grassy area in front of a tree.
El hombre tiene puestas almohadillas de codo y un casco.	The man has on elbow pads.
Dos jinetes en sus caballos en una pista de carreras.	Two dogs racing on a track.
Un hombre está de pie junto a dos niños en un día caluroso.	A man and woman are running to the store on a Summer day
Un hombre con una camisa azul está en una choza en una aldea.	The man in a blue sweatshirt is in a kitchen.
Un camarógrafo sale a comer con su familia.	A man is waiting for his friend to catch up.
Un hombre está sentado en un taxi.	The woman is in a taxi cab.
La nariz tiene un moco dentro.	The dog has a stick in it's mouth.
Un hombre que está pescando está relajándose mientras pesca.	A man is fishing alone.
Dos personas están hablando de la vida en una mesa.	There are two people looking at a book.
Un hombre está en una escalera cerca de tanques enormes.	A man on a ladder is power washing a building.
Hay muchas personas afuera antecediendo una figura ampliada gigante de Oscar el Gruñón	Many people are leading a giant blow-up figure of Oscar the Grouch in his can down a street.
Una persona está tratando de golpear la pelota.	A child is trying to hit a ball.
Un vaquero y su caballo resbalan en el barro.	Man with cowboy hat loading a chest onto a pack of horses in the wilderness.
Los hombres se sienten acalorados.	The people get wet in the rain, and they think it is funny.
Una monja busca armas en un sacerdote.	An elderly man is holding a gun.
Una persona en un traje de Bob Esponja espera un hot dog.	A dog is in a dog show.
Travesuras en una piscina cubierta.	A little girl is covered in a towel at a swimming pool.
Los bebés están trabajando en un sitio de construcción.	Two people are working at a construction site.
Los perros duermen amontonados.	A dog laying in the water.
Un perro corre a través de un charco de barro	A child scoops dirt into a bucket.
Los niños están en un torneo de karate.	Two martial art students spar in a tournament.
Hay un buffet de tacos.	The buffet is only seafood.
La mascota tiene una correa por seguridad.	This man has safety gear on.
Algunas personas esperan un taxi.	Some people wait for a train.
Un accidente automovilístico	A crash immobilizes a car.
La banda está en un desfile.	The band is in a Christmas parade.
Persona a caballo	The person rode a horse.
Una cortadora de césped está justo al lado de una persona.	The guy is standing next to a tree.
Algunas personas en un edificio.	People are in a building.
Un hombre estaba en una carrera con un scooter.	A man running in a race.
El equipo amarillo y verde jugó fútbol	the football team is wearing red and green
Las mujeres están sentadas en el telesquí	The people are on a ski lift
Un gran número de trabajadores de ferrocarril que visten chalecos anaranjados que brillan de día y sombreros duros están de pie en algunas vías del ferrocarril.	Several workers in orange vests and white construction hats holding blue bags are working along side railroad tracks.
Un muchacho asiático joven corriendo con un perro blanco y gris en hierba verde.	A black dog and a brown and white dog running in the grass.
Una madre e hija están cocinando.	An older woman is cooking for her family.
Una banda afroamericana está tocanda al aire libre en un escenario rodeado de árboles.	There is a band performing in front of a large crowd
Un hombre sube los escalones entre dos casas por la noche	Two people sit at a table under a tent as a third man stands near them.
Una señora caminando afuera.	a lady and girl walk outside
El aula es para adultos solamente.	The children are in a classroom.
El hombre está volando un transbordador espacial.	THere is a plane in the hangar.
Una mujer con ropa cómoda está arreglando sus uñas de los pies.	There is a women getting her hand painted
Hay un hombre mayor, planchando una camisa para su trabajo.	A man with a shirt is doing work.
Un techador profesional piensa sobre cuán mejores son otras formas de techo.	The human has some floating things while in the white hard stuff.
Un perro marrón y blanco parado en la orilla del río mirando a su amo.	A brown and white dog is standing in the river by the bank.
Él siente el ritmo	Nobody is playing the drumset.
Dos personas cruzan la calle frente a una ambulancia.	A group of people are walking along the side of the road.
Un muchacho joven juega un videojuego en un restaurante de McDonald's.	A boy plays a video game at mCDonald's
La mujer está fuera esperando un paseo.	A woman is waiting for the bus.
Cuatro chicos en un barco juntos	Three boys put together a sailboat.
Un perro marrón corriendo a través de un campo abierto.	A brown dog runs through a field.
Grupo de niños peleando.	A group of girls
Gente mirando un jardín	People sitting at a garden.
Una mujer que lleva algo parece feliz.	A man is helping someone get dressed.
Dos perros pequeños están en una jaula afuera.	The two dogs are in a cage.
Las señoras están trotando por la calle.	The men walk down the street with their kids.
Una persona anima desde las gradas.	A person standing in a crowd.
Los animales están en jaulas en el zoológico.	The dogs are in cages.
Hombres con cabello largo tocan instrumentos mientras su perro se acuesta en el sofá	The dogs are playing with a rope.
Una muchacha con cabello castaño oscuro se está sentando en un mesa y mirando sobre su hombro.	A woman with orange hair is looking over her left shoulder.
Un perro blanco y negro acostándose con un palo grande bajo su pata.	A white and brown cat is laying down on a red jacket with a rodent standing on it.
Un grupo de personas dirige un flotador	A group of people on a break.
Dos mujeres jóvenes con camisetas negras comen en una mesa.	The two women in blue shirts eat dinner with the kids.
Los perros beben un poco de agua en la hierba	The dogs are in water.
El hombre del sombrero gris se ha resbalado en el hielo.	The boy in the green shirt swings with one arm on the silver pole.
Ciclista manejando bicicleta.	A skier skiing.
Dos personas se sientan en un banco de madera por los árboles delante de un edificio blanco.	Man laying on a wooden bench with other people in the background.
Tres perros miran como un ser humano sostiene una bola rosada en la playa.	A man and a dog are on the sand.
Una pareja está paseando a sus perros al aire libre.	A couple are walking outdoors.
Un hombre joven bailando para una pequeña audiencia.	A sad woman putting on a dance for a small audience.
Algunos gatos corriendo en el desierto	The dogs are running in the desert.
Un hombre en un abrigo azul pasea a un pequeño animal blanco mientras un bus pasa en el fondo.	A person in a red dress is running behind a black animal.
Los monjes estaban jugando a saltar la cuerda en la carretera.	Two men are playing jump rope in the middle of the street.
Dos mujeres están escalando.	Two men are jumping.
Un anciano esquiando cuesta abajo mientras nieva.	A skier going down the snowy hill.
La comida es barbacoa	the food is hot
Una familia camina bajo grandes vigas de madera.	A person sitting under trees and a large metal sculpture.
Un auto dragster naranja estacionado en la pista.	A race car is on the dirt track.
Hay al menos dos machos.	The two people are both males.
Un niño y una mujer están en la nieve paseando en trineo y jugando.	A man and a child are sledding in the snow together.
Un muchacho joven en los zapatos de velcro y una camiseta azul cuelga de un arnés en un muelle.	A man in a blue shirt is looking up at a dog.
Los tres actores están en el escenario actuando.	Two men are performing on a stage.
Trabajadores de emergencia con mangueras alineadas y descendiendo por las escaleras.	Firemen looking down a set of stairs.
Un hombre se está besando con su esposa en una muchedumbre.	A man is showing off for his friends.
Un tipo pinta un anuncio.	A man paints a picture.
Tres niños se sientan en un asiento al aire libre.	Two women sitting in a room.
Hay un hombre vistiendo una camisa amarilla montando un monociclo.	There is a person wearing a red shirt riding a skateboard.
El niño en traje de baño está tendido boca abajo sobre un pavimento húmedo.	A dog with mud stuck on his underside is running on grass.
Las niñas cantan	people dancing
Un muchacho asiático joven está dando a muchacha asiática joven un paseo en sus hombros	A white Asian boy is giving young asian girl a piggyback ride.
Una persona está yendo a trabajar en su bicicleta.	There is a person working on a bicycle.
Personas llevando comida en bandejas	People holding containers on alcohol.
Las fortunas dichas resultarán ser verdaderas.	The street post does not have anything on it.
Una carrera de bicicletas en la nieve se detiene mientras que la bicicleta del ciclista es reparada por un mecánico.	This man is riding a skateboard on a bike jump.
Un hombre de pie en una sombra.	A man is standing on a ladder.
Tres hermanos posando fuera del negocio familiar.	A group of friends are shopping.
Una multitud mira a un hombre cortar troncos.	A blond-haired man in a blue shirt surrounded by screens sitting at a desk and talking into a microphone.
El hombre está con un perro.	The dog is with a woman.
Un hombre bien vestido caminando por una zona rural	A man and a boy are walking in a deserted area.
Una mujer afroamericana mirando en un microscopio con imágenes de microorganismos en su escritorio.	A woman and a girl view a piece of artwork up close.
Un hombre afeitado corre a toda velocidad por la acera con un leotardo blanco.	A young woman with a shave head in a brown skirt and sandals walking past a stone building.
Una mujer y un hombre se están besando en el paseo tablado.	A man is sleeping between two flags.
Un hombre de pie en un acantilado.	A man on a cliff.
El pájaro está en el árbol	The bird sits on the tree branch.
Los ciclistas en una carrera de bicicletas giran bruscamente a la izquierda.	A rally race car is navigating around a turn on a race course surrounded by hay bails.
Dos mujeres compiten en uma pelea de kick-boxing.	Two women compete in a soccer match.
Las mujeres están audicionando para el Lago de los Cisnes.	Some boys are going swimming in the lake.
Los niños están jugando fútbol americano.	The boys are playing baseball.
Dos niños están sentándose en una playa.	Two girls prepare a small sailboat as two boys watch them from the beach.
Él completa con éxito un conjunto de movimientos de artes marciales.	A martial arts student kicks a wooden board to advance in his rank.
El hombre con el equipo amarillo está a punto de hacer rapel desde una distancia alta.	A person in black is off in the distance.
Los trabajadores de construcción se sientan cerca de una vía de ferrocarril.	A line of construction workers walk along a train track under an overpass.
El tipo gruñón está tocando un instrumento afuera	there is a guy playing an instrument.
Tres fotógrafos tomando una foto de un patinador que realiza un truco sobre uno de los fotógrafos.	The photographer is taking a picture of four women looking at the camera with blank faces.
Tres hombres jóvenes se paran contra una pared conversando mientras que un muchacho joven mira hacia adelante sosteniendo un cartel.	Two young boys hold a man's hands.
Pequeños niños asiáticos preparándose para un juego deportivo.	The kids are playing a friendly game of one on one soccer.
Un hombre está asando pato en su horno	A man having a piece of chicken.
La actuación estará en las noticias.	The sign has at least one word on it.
Un perro olfatea otro perro.	a dog chases another dog.
El músico decidió quedarse en casa esta noche.	The man waited until night to go home.
Los dos hombres con chaquetas azules son hermanos.	The two men in blue jackets are sitting down.
Varias personas están caminando.	There are several people walking.
Un granjero reúne sus vacas.	A farmer drives on two cattle to plow a field for his work as he grows corn crops
Tres personas miran fijamente las pantallas del teléfono móvil.	Three people are smiling at the camera.
Una mujer trata de alejar a los niños de sus padres.	Man giving the child back to parents
Un hombre llega a trabajar con los cables por encima de un escritorio.	Man puts his feet up on a desk.
La roca está a punto de caer sobre el hombre.	The rock holding the boy is about to roll.
La niña está caminando	the boy is walking
Un niño viste una camiseta de David Wright al aire libre.	A young man is wearing a suit outdoors.
La sudadera del hombre es gris.	the man is wearing gray
Una mujer que viste pantalones negros está sosteniendo un martillo perforador al lado de una calzada de cemento roto.	A woman wearing a blue skirt is on a walkway looking at a body of water.
Un grupo de personas posan delante del océano.	A small group of people are sitting on the bank of a large body of water in the grass.
Un hombre y un niño están arreglando un camión en un garaje.	A man is working on a truck.
Un tipo repara una chaqueta.	A man repairs a shoe.
El hombre baila en la calle mientras otro mira.	A woman and a man are dancing in the street.
Chicos juegan en un parque	people playing a game at the park
Dos competidores están en un carrera.	Three runners are racing.
Los hombres en azul se paran ante la columna.	Woman in pink top walking past 3 men sitting on the steps.
Una anciana contempla la vida en un banco del parque.	An old man lays on a park bench.
Un procedimiento dental.	A child is receiving painful dental surgery
Los niños tienen caras muy limpias.	Some people are making funny faces while they get their picture taken.
La pareja estaba lejos en su luna de miel	The couple smiles before leaving for their honeymoon.
Los perros de trineo están afuera.	The dogs are pulling a sled.
Un grupo de carniceros están probando recetas hechas con carne que cortan.	The cooks are putting together the ingredients for a massive burrito.
Un hombre haciendo windsurf en el océano.	A man is snorkeling in the ocean.
Un niño sobre los hombros de un hombre.	a man and a boy in shorts stand on a bridge
Un hombre en un parque de patinaje está haciendo un ollie en un half-pipe frente a la playa	A man in a skate park is doing an ollie in a half-pipe near the beach
El hombre tiene barba.	A bearded man is outside.
Dos mujeres esperando que la luz del paso peatonal cambie a verde.	The people are waiting for the light to turn green.
Las mujeres limpian los escombros dejados en su porche	Woman inside sweeping the floor.
Los madereros ilegales talaron un árbol gigante en el bosque primaveral.	The spotted dog chews on the bark of a pine tree.
Un atleta se está moviendo.	The athlete is moving.
Los dos niños están jugando a las escondidas.	the boys are home playing hide and seek
Un hombre usa un sombrero y espera un bus.	A man in a blue shirt and a hat is sitting in a truck.
Un hombre construyendo su casa.	A man building a house.
Las herramientas de jardín están en el invernadero	The street is empty and the buildings are white.
Ella está caminando a través del parque público.	A person is walking through the park.
Un hombre con un suéter rojo espera en un stand de comida callejera.	A little girl is standing on the street, holding a red bag.
Un hombre tiene el cabello castaño junto con una mujer que tiene cabello rubio.	a women with blonde and brown hair has her arms around a man
Un niño pequeño está afuera.	A woman is near a little kid.
Un hombre hace malabares para una multitud.	A man and a crowd.
Un perro negro corriendo muy rápido con una mujer rubia corriendo tras él en el fondo.	A young girl doing a back flip in the water.
Una mujer sentada en una silla mostrando a los niños un libro.	A female child turns the page of a book while she sits on a colorful stool
Dos hombres con trajes andan en bicicleta por un cruce de peatones.	Two men are jogging on a trail.
Dos hombres tomando el cálido sol.	The men are in the hot sun.
Dos personas están de pie fuera de una tienda en una calle de la ciudad.	The people are standing in a crowded store.
Las bicicletas están en una carretera.	Bicycles are laying on the side of the road.
La gente paga por sus compras en la tienda.	Families wait to enter the store for a big sale.
El tipo está en casa durmiendo.	The guy is sleeping at home.
El niño terminó de abrir todos sus regalos de Navidad.	A woman is in the process of changing her clothes for her big date tonight.
La gente está feliz de estar en la playa.	People are at a beach.
La dama está sentada cerca de la fruta.	A lady in green is walking outside.
El niño de color blanco está en las barras, mientras que el de color marrón está de pie abajo.	The two girls are in the water and one has a white shirt on.
Mesera trabajando en un restaurante cortando sandía.	a restaurant makes vegetables for everyone who enters
Un hombre está haciendo compras en el centro.	A man is shopping in a mall.
Un jugador de hockey está patinando sobre hielo.	A hockey player is sitting on the ice.
Hay una mujer montando a caballo.	A person is riding a horse outside.
Un hombre en una tienda	A man in a supermarket.
Un hombre saltando en el aire	A man is jumping into the air.
El perro está dormido en la cama.	A dog is asleep on the bed.
Tres nadadores se están preparando para que comience su competencia natación.	The swimming competitors prepare for their meet.
Los dos hombres están corriendo.	two of the three men are running.
Un hombre está leyendo un libro cerca de la chimenea.	A man is reading a book on the couch.
El hombre está de pie después de su actuación en la obra.	the person is taking a break from the game in the picture
Una niña pequeña corriendo en un campo	A little girl is running in a field.
Un grupo de personas mira como la novia y el novio intercambian sus votos.	A group of people wait for their turn to cross the street.
Después del nacimiento de un bebé, las enfermeras se aseguran de que está bien.	The woman is getting ready for the day.
Dos hombres de pie en un área para dormir.	Three men are walking in front of a tent.
Un hombre está bombeando aire en las llantas de su bicicleta.	A man is pumping air into his bicycle.
El hombre estaba hablando por teléfono en el baño.	A man is by the door looking at his phone.
Un hombre dormido en una fuente al aire libre.	A man is looking at an outdoor shower.
Una mujer corriendo por la calle sosteniendo un acordeón.	A man in a business suit walks down the street.
Un niño pequeño tomando fotos.	A man and little boy are getting a picture taken.
Una mujer dando una conferencia sobre el impuesto a la propiedad.	A man is working at a cash register.
