two men are crying	رجلان يضحكان.
A tired businessman takes a quick nap while riding the train.	يجد رجل الوقت لأخذ غفوة في سيارته الكهربائية.
A man working on a light that has been broken for a week.	كان يوم عمل المرأة شاقا وهي ملتوية للأسفل .
A man is attempting to fix the air compressor.	رجل يستخدم خرطوما فائق القوة لإخماد الحريق .
a twelve year old girl eats chocolate ice cream	فتاة تأكل آيس كريم.
a man holds a pro Judea protest sign at a protest rally	رجل يحمل لافتة احتجاج
A woman holds a little boy wearing a blue sweatshirt.	امرأة تحمل طفلا مبتسما يرتدي قميصا أزرق.
A bike riding blond child.	الفتاة تركب دراجتها .
people are in the road	الناس بالقرب من الطريق
The windows are tall.	النوافذ مفتوحة.
A man is being chased by the police.	تعتقل الشرطة رجلا
A girl has binoculars	فتاة شابة تحمل كاميرا
Two people ride red bikes.	رجلان يقودان إلى آخر الطريق
Two people are standing next to each other wearing pink.	هناك ثلاثة رجال، اثنان منهما يرتديان قميصين أحمرين يثرثران معا
A black woman is buying donuts at the store.	المرأة تنظر إلى الشامبو في محل للبقالة.
The man works in the local market.	مجموعة من التجار يعملون في السوق.
A woman in red wears glasses and long earrings.	امرأة تلبس نظارات، وأقراطا كبيرة، وغطاء على رأسها.
Skateboarder in midair at a park.	رجل في الهواء الطلق حديقة تزلج.
a man working the kinks out of his old bones	الرجل يعمل بيده
A woman in a one-piece bathing suit with a man on a boardwalk on a foggy day.	رجل يرتدي بذلة وامرأة ترتدي ثوب زفاف يسيران على رصيف مبتلّ.
A man in a blue shirt helping a man in a red shirt fix a car.	رجل ذو قميص أزرق يساعد رجلا ذا قميص أحمر ليصلح مسار دراجة 
A girl kneels on the ground with her friend.	تفترش أم الأرض مع ابنها
The gymnast is a few feet off the ground.	شخص في الهواء مع الزلاجات على أقدامه.
Boy walks past man in orange overalls who is sweeping garbage from the street.	المرأة التي تحمل حقيبة سوداء تعبر الشارع.
Two men are trying to drink beer while tubing.	إمرأتان تحملان مشروبات وهما تسيران.
The man is riding a jet ski.	كلب يركب طائرة.
Girls are standing up.	الفتيات واقفات .
men sitting on their couch while eating bull	امرأتان تجلسان إلى طاولة ملابسهما تشبه الضفادع
A man is bending down in a park next to a woman on a bike.	رجل في كرسي متحرك يسير أسفل الرصيف
Two men on a platform	أربعة رجال على منصة.
The homeless man is alone in his box.	الرجل وحيدا في المنزل
A bunch of people gathered on a beach.	مجموعة من الناس على الشاطئ.
The girl is sitting and drinking water.	فتاة جالسة تشرب ماء .
A lady shows a guy a reptile while another child is in the background.	فتاة تلتقط صورة لفتاة أكبر سنا في حديقة واسعة
The people are not clapping.	الأشخاص كلهم عابسون.
Jockeys race the fast horses.	فارسان يتسابقان على الخيل.
They are playing with an antique set.	الرجال بجوار طاولة.
The people are in the water.	الناس في الماء.
A young man who looks Oriental is selling things.	تحب الفتاة الشابة حذاء ليس حذاءها.
A group of women practice yoga in the backyard of a yellow house.	مجموعة من الأشخاص يجلسون في ملابس السباحة على شاطئ في أوضاع اليوغا.
The boy is ready to take a swing at a ball using a bat.	صبي يستعد لإمساك كرة.
Four women wearing bicycle riding clothing sit on a bench.	رجلان يجلسان على العشب يرتديان خوذات الدراجات.
The man is taking a picture of the Empire State Building.	المرأة في الجيش.
The people are sleeping in the snow.	الناس في الثلج.
The insect is from Mars.	الحشرة تطير.
A group of people eating outdoors.	مجموعة من الناس يأكلون
A teenage pole vaulter is performing.	المتزلج ينفذ قفزة.
The girl is learning how to use a microscope.	امراة كبيرة فى السن تظهر كيفية استخدام طاولة الغسيل للقيام بالغسيل.
Two men dressed in white shirts button down shirts, white hats, with blue scarves tied around their necks	ثلاثة رجال يرتدون أقمصة حمراء وبيضاء مخططة، وسراويل بيضاء وقبعات سوداء يحملون أعلاما.
A man is that just purchased and put on a rainbow colored necklace and is very happy.	رجل وطفل على الرمل.
The young boys are brothers.	الولدان الصغيران شقيقان .
Two kids are in a field.	كلبان يعملان في حقل
There were only strawberries to eat at the baby shower.	الناس في حفل الوليد
There is a bear in the jewelry store.	المرأة في المتجر تبحث عن أشياء في المؤن
A man is holding a computer monitor.	رجل يعمل في نافذة.
the man is using a heat suit control the flame	رجل يستخدم موقد اللحام لإذابة البلاستيك.
Superman breaks down the sign so the group may pass	الثور يحاول إلقاء الرجل للخلف
The people are standing in line at the water slide.	مجموعة من الناس ينظرون عبر السور على الماء والأراضي المغطاة بالضباب.
A child is laying in a bed in a medical setting.	طفل في سرير.
A woman pops a bubble.	فتاة تنفخ فقاعة بواسطة عصا
The 2 drunk men are standing in the street getting ready for a fist fight.	الرجل ذو القميص الأحمر جالس في سيارته في انتظار المطر أن يتوقف
The dog is chasing a lizard.	الكلب يطارد شبحا.
A women and two children are walking between buildings in the rain with an umbrella.	امرأتان في حقل بلا مبان تحيط بهما.
A person asking for directions	شخص يسأل عن إرشاد.
The woman is trying to make the man get up.	زوجة السائح غاضبة من الرجل الذي لا يستطيع أن يُعمِل عقله.
Roller blade cops are talking.	قليل من الرجال يقومون بقفزة خلفية.
A tall human falling	إنسان طويل القامة قفز.
A Chinese farmer is working in a rice field	مزارع آسيوي يمشي في حقل أرز مع ثور.
A father rides a horse while his daughter stands nearby.	رجل يركب دراجة، تركب ابنته بجانبه.
The men try to show the coach what they're made of.	كلا الرجلين في عجلة من امرهما لانجاز المهمة.
a man smokes a cigarette.	امرأة تدخن سيجارة
A player catches the football in the end zone.	 لاعب كرة القدم يركض إلى المنطقة الأخيرة.
The band is performing on a stage.	الفرقة على خشبة المسرح.
The beam is firmly in place.	ثُبِّت مصباح الإنارة على الأرض.
The family gets a portrait taken	يلتقط الرجل صورة لصديقته.
A group of children are stretching.	توجد مجموعة من الأطفال في الخارج.
People walk by through a city juggling.	الناس يدخلون من خلال المدينة.
The man is walking by a mural.	رجل يسير من اللوحة.
A lone woman walks in the surf at the beach.	امرأة يمشي بين الأمواج على الشاطئ.
A man in a white shirt and a woman in a black shirt riding a motorcycle.	رجل يرتدي الجينز، وقميصا أحمر يركب دراجة نارية على الطريق السريع.
Two men are searching for canned goods	رجلان يبيعان الخضار.
A sharp looking man is cruising in the sunshine.	رجل يقدم حيلا على دراجة مرتفعا جدا في الهواء.
a boy steals an apple alone	رجل لديه لعبة شخص ما.
A woman is training to be an expert shot with a pistol.	رجل يستخدم كرسيا متحركا يتحدث في حقل لبضع نساء.
A mother is cutting fabric into squares for a quilt.	امرأة تقطع القماش.
The small boy is sleeping.	هناك صبي بالقرب من الأحذية.
woman goes grocery shopping	امرأة تسوق البقالة
the father plays catch with his son	يلعب أب وأبنائه كرة السلة.
A man cuts a melon.	رجل يقطع كعكة.
An asian woman with a microphone stands amongst a crowd of raised hands.	امرأة تقف في حشد من الناس في آسيا.
She is watching a movie inside.	رجل يجلس ويشاهد فيلم.
two black dogs on the beach	ثلاثة كلاب سوداء على الشاطئ.
The man's hands are full.	النساء يضعن أيديهن على رأس الرجل.
Humans in shirts.	الكلب والدجاج لهما نفس الألوان.
A woman is taking a break from reading her book.	امرأة شابة تأخذ صورة أثناء استراحة قصيرة من وظيفتها كنادلة.
The man is waiting on someone by the building.	رجل يقف إلى مبنى الانتظار لشخص ما.
A man is sleeping while the woman watches silently.	عجوز تنام عارية بمفردها.
A man plays piano with his shoes.	رجل يلعب الكمان مبتسما.
Two kids having a snowball fight.	فتاتان تتعاركان بالوسادة.
A girl is crying in the park.	رضيع يبكي في الحديقة.
The man is playing a round of golf.	أُحزِن الرجل في اللعبة.
A canine is in the field.	الرجل في الميدان.
A mountain biker jumps off of a fence while going downhill.	رجل متزلج انحدر انحدارا حادا.
A woman uses a high tech sewing machine to make a scarf	تستخدم امرأة ماكينة خياطة لصناعة الملابس.
Group of black men loading luggage onto the top of a bus	مجموعة من الرجال يقومون تحميل البضائع على الجزء الخلفي من السيارة.
An artist drawing.	فنان يرسم.
The people are not standing.	الناس كلهم واقفون.
Two guys are having lunch in a Chinese restaurant.	امرأتان تنتظران وجبة في أحد المطاعم.
A boy is putting his black socks and shoes on his feet.	صبي يقلع حذائه الأسود.
The man is standing next to a sheep.	رجل يقف بجانب كلب.
Young man in blue shirt peering through a large bubble.	رجل يرتدي قميصا أبيض ونظارات شمسية يحدق في الأفق.
A woman sits fanning herself	وقالت امرأة ذات الشعر الأحمر يجلس داخل
The blow-up figure is Karl Marx.	هناك لوحة لألبرت أينشتاين وهو على دب.
A male and female worker is whipping up a meal.	يقدم رجل الطعام لأنثى ترتدي لونا ورديا.
Workers are standing near the tracks.	عاملان في الشمس
Two kids wearing cold clothing look happily down through a tire swing for a picture.	طفلان يرتديان ملابس دافئة ينظران تحتهما بسعادة عبر إطارات الأرجوحة من أجل التقاط صورة.
people walking a standing in a city park.	أناس جالسون في حديقة عامة.
men sitting on steps with a dog	رجلان يتحدثان مع رجل آخر في الشرفة
Two men with long hair sit on sofas.	رجلان يرتديان قمصانا سوداء يضعان رجلا على رجل تحت أجهزة الكمبيوتر المحمولة الخاصة بهم على الأريكة.
two children riding horses in a rural setting while playing lacrosse	الفتيات يتجهن للمنزل.
A man tying his shoe at a beach.	رجل يأخذ استراحة مع كلبه في حديقة عامة.
Three people hang out on top of a big hill.	مجموعة من الرجال في الجزء الخلفي من سيارة نقل عل مرتفع عال
A car is driving in the mud.	الرجل في الشاحنة يقودها مبتعدا.
A little boy got his pants wet.	بلل الصبي سرواله.
A group of women yelling at a man.	رجلان يصرخان في امرأة في السوق.
the woman was driving fast	رجل و حيوانه في قارب سريع 
Two men chatting about a bank heist.	 مجموعة من الرجال متجمعون حول سيارة مكسورة بالأسفل .
The person is dead.	الشخص ميت.
a group of basketball players trying to get the ball from another player.	لاعب كرة سلة يحاول أخذ الكرة من آخر.
Two girls are reading books outside.	ثلاث فتيات تقرأن كتبا.
A boy in a black t-shirt gets ready to throw.	 طفل صغير يحصل على حصان أسود.
A snowboarder jumping high.	متزلج يقفز عاليا بينما هو على لوح التزلج .
Child playing with a hula hoop in his home	 طفل يلعب بهولا هوب.
The man is woman are in a relationship.	المرأة تتحدث.
An audience at a concert.	 ممثل على خشبة المسرح في حفل
the adults are inside	بالغين يجلسون في الداخل.
There is a group of young men playing instruments.	هناك مجموعة من الرجال يعزفون الموسيقى.
A baby is chewing on his fingers while wearing a cute blue striped outfit.	فتاة صغيرة ترتدي قميصا أحمر و سترة تنفخ فقاعة في عصا كبيرة.
There are only two athletes	بعض الرجال يركضون
The girl is a starving, homeless child in Africa, and missionaries have given her bread to eat.	رجل يقدم طعاما لطفل .
A man in a green shirt making a cup.	رجل بقميص أزرق يحمل كوبا .
An older woman had a cart full of groceries.	رجل يقود عربته المليئة بالمشتريات .
A man carrying steel beams across a lumberyard.	أثاث يقبع داخل شاحنة متحركة في منحدر.
The food the child is eating is sweet.	الصبي يأكل طعاما.
a player throwing a ball is tackled by another	لاعب يرمي كرة.
Black dog playing with toys	صبي صغير بتبان  قصير أحمر يضحك.
The elderly man is resting on his bicycle.	الرجل يجلس منتظرا دوره .
Man sitting at the end of a row of green chairs by some payphones.	أشخاص على كراسي قابلة للطي ينظرون من منحدر .
The people are doing the back stroke.	الناس يأخذون استراحة.
The woman is wearing a uniform	المرأة ترتدي قبعة.
The carpenter is taking a break.	 كان النجار يأخذ استراحة.
A baby in pink is held.	إمرأة بالوردي تعد طعاما لطفل بالأزرق يجلس تحت الطاولة.
Someone is dressed in clothing and putting her face in front of a talking tube.	 إمرأة بقميص أخضر وتحمل كاميرا و محاصرة من مجموعة من الناس.
A brown dog with a blue collar is running.	كلب بني يرتدي طوقا أزرق يجري على العشب.
Two dogs are playing in a yard.	كلبان في منتزه يلعبان .
A dog with a Frisbee in its mouth is running through snow.	كلب بني يجري في الثلج بطبق طائر في فمه.
Two women standing near the subway	هناك ثلاث نساء يقفن في محطة الحافلة.
This marketplace features multiple vendors selling fruits, vegetables, and other items.	 مركز سوق الفاكهة يعرض الخرشوف، والعديد من أنواع مختلفة من الفاكهة.
Man sleeps outside store	رجل ينام خارجا.
The man is racing down the mountain.	الرجل يتزلج أسفل الجبل.
Four Mormons walking along the beach.	شخصان يمشيان على طول الشاطئ.
A man in a black swimming suit is holding onto the edge of a in ground pool.	 إمرأة ببدلة سباحة تتمسك بحافة بركة السباحة.
The man is using a shopping cart.	رجل يسير عبر وول مارت مع عربة مليئة بالأشياء.
People walk beside a stone wall.	رجل يسير أسفل ممر من مجموعة من واجهات محلات تجارية.
A man play football in the park.	رجل يلعب كرة القدم في المنتزه.
Two young individuals are playing drummer boys using soda cans and drumsticks	طفلان يلعبان بالسكاكين.
A man is sleeping with a small dog.	رجل لديه كلب صغير.
The jeep crashes onto some rocks.	كثير من السيارات متوقفة على جبل.
A band performs on a sidewalk.	فرقة تعزف على الرصيف.
The boy had a black hat and red shirt on while skateboarding.	 ظهر صبي صغير يرتدي قميصا أزرق وقبعة حمراء.
The young man is jumping.	هناك ولد صغير يقفز.
A reader is telling the children a story	شخص يقرأ كتابا.
A man with a suit and a name tag is sitting outside, waiting to start a presentation.	 إمرأة ببدلة تتحدث إلى رجل على مقعد .
Boy laughs while playing in mud puddle.	صبي بلبس سباحة يصرخ في حين يجرى رشه بالماء.
a man examining plants	الرجل يزرع نباتات.
The children stole a bike	امرأة في بيكيني أبيض تقود دراجة هوائية، والناس يمشون ويقودون خلفها.
A man stops for a picture with the scenery during his hike.	رجل يأخذ صورة لمنظر لم يره من قبل.
Teenagers are swimming.	ثلاثة مراهقين يسبحون.
Man riding his bike in the street.	شاب يركب دراجته في الشارع.
A toddler in a frilly dress shows her joy.	امرأة ترتدي ثوبا ملونا تمشي.
The child in a jacket has a round toy.	امرأة تربط حذاء فتاة ترتدي الأرجواني.
A woman teaching a young girl not to be afraid of puppies.	امرأة تتحدث إلى الأطفال.
A man and child are riding an elephant.	امرأة وطفل يركبون دابة.
Three men are drinking apple juice while on the beach.	رجلان ببدلات يشربان القهوة على طاولات متقابلة.
A group of people.	مجموعة من ثلاثة أشخاص.
people in a house	يتحدث الناس خارج منزل.
The road is closed down.	الشمس تغرب.
Two people kissing.	شخصان لا يقبلان بعضهما.
A sad male is playing electric guitar while wearing a white hat.	رجل يلعب الغيتار الكهربائي مرتدياً قبعة بيضاء.
the beach is mainly isolated except for a few families and some rain	بعض الناس في غابة.
A black mother and five children in a rural area	رجل مع ولده على الخيل في مناطق ريفية زراعية.
A woman is assisting a runner by keeping rain off of her and giving her hydration.	امرأة تنتظر المطر مع مظلتها.
The person is making fabric.	هناك شخص مع قماش.
Woman in shorts and a t-shirt with seated men, watching someone perform.	المرأة تلبس سروالا قصيرا وقميصا قصير الأكمام تقف إلى جانب بعض الرجال الجالسين ويشاهدون العرض أو المتحدث.
Two adults swing high toward the camera at a playground park.	شخصان بالغان يتأرجحان في منطقة الألعاب .
A man is about to release a ball.	امرأة على وشك قذف كرة.
People from a bike race.	الناس في سباق الدراجات.
A young girl is throwing food to some ducks in a pond.	فتاة صغيرة تجري أثناء إطعام البط.
A person swimming underwater poses for a picture with some underwater vegetation.	رجل يقوم بوجه أبله تحت الماء في بركة أثناء السباحة.
The trees had a dog near them.	رجل في الخارج قريب من الماء
Two surfers are competing in the open water against each other.	كلبان بتسابقان مع بعضهم البعض في الماء.
A man in shorts, a sweatshirt, and sneakers is mowing the grass.	امرأة في قميص أخضر وسروال أسود تركض.
A woman is running on a lawn.	شخص في زي أبيض يجلس على دراجة.
City workers are helpful.	الناس تساعد في الخارج.
A snowboarder wearing a blue jacket and green pants running from an avalanche.	رجل يرتدي سترة زرقاء وسروال بني يسير مشياً على الأقدام إلى أعلى الجبل.
The two kids are fighting each other.	طفلان يتقاتلان مع بعضهم البعض.
A man is giving a speech and a woman is holding a cowboy hat.	رجل يتحدث إلى امرأة تحمل قبعة رعاة البقر.
Tall humans pushing	البشر طويلي القامة يشيرون
A boy holding a float.	صبي يحمل حبل.
Children listen to a teacher read a story.	الأطفال الضجرون يستمعون إلى أستاذة جذابة/أستاذ جذاب تقرأ القصة.
Someone is trying to trim the plants	عمال يفعلون شيئا ما لشجرة.
The old man is playing a banjo.	رجل يلعب البانجو في الخارج.
Nobody is wet	الرجل يتبلل.
The woman is playing a game inside.	رجل يلعب لعبة في الخارج.
A woman holds a baby on a boat.	رجل قبّل امرأة على متن قارب.
An ice skater practices	امرأة جذابة تتزلج على الجليد.
A group of people standing in a courtyard on a tour looking up at people out on balconies above.	مجموعة من الشباب يقفون على الرصيف في الليل.
A young girl.	فتاة صغيرة تحمل صبيا صغيرا.
The woman on the bike was riding fast.	رجل يركب دراجته ورأى شروق الشمس.
People are walking in a long hallway with blue walls.	العديد من النساء تمشي من خلال بناء قرميدي بعباءات باهية.
A girl braiding her hair.	امرأة تجدل شعرها.
The woman refused to look at the old camera.	المرأة تريد من الطفل أن ينظر إلى الكاميرا.
Man roller skates for a crowd to watch.	رجل يقوم بقفزات موتوكروس في حين الحشد يشاهد.
The man is a the library.	الرجل في المكتبة.
A little girl swimming in the ocean.	صبي صغير يسبح في المحيط.
The man is flexing his muscles.	رجل يستعرض عضلاته.
Two men are fighting over who gets to speak into the microphone.	اثنان من النساء يقفون ظهراً لظهر.
The man is doing cartwheels down the street.	رجل يسير بسرعة في الشارع.
A groom and his wife kiss while posing for photos.	العروس تقف للصور مع أفراد أسرة زوجها الجديد.
Dogs on a mountainside with their heads in the ground.	الصبي والكلب خارج الحديقة مع القليل من الثلج لا تزال على الأرض.
The man with the beard is driving his car.	الرجل الأسود يقود سيارته بكلتا يديه على عجلة القيادة.
It is raining very lightly.	إنها تثلج بغزارة
Two children dressed as clowns on ropes performing with other children.	طفلان بزي مهرجين يتأرجحان على الحبال فوق أطفال آخرين، الذين هم أيضا في زي.
A homeless person is taking a nap.	هناك شخص بلا مأوى يأخذ قيلولة.
A man is sitting watching a parade of clown cars.	رجل يراقب الموكب.
Multiple people carry a sesame street float through the streets for a parade.	شخصان يركبان دراجاتيهما في الشارع مع شخص يقف على القرب منهما على الرصيف.
two men holding cats.	الرجال الثلاثة يطاردون كلب.
A female is vaulting at the Olympics.	لاعبة الجمباز في المسابقة.
A man is eating some cake as he walks.	يبدو أن رجل يحصل على الكثير من الحب من سمكة قرش بيضاء ضخمة.
A man is resting from a wipeout he had due to a hard trick	تأخذ المرأة استراحة.
A person is checking out buildings to buy.	رجل ينظر إلى بعض المواد الغذائية على عصا ليشتري لنفسه أو لشخص آخر.
The man is at the office.	الرجل في الغرفة هو المخرج.
A musician plays guitar while sitting.	يلعب موسيقي الغيتار.
The biker is riding in a bike race.	النساء يركبن الدراجة في سباق الطريق.
The Vons shopping carts are being loaded onto the truck by a man.	كانت مجموعة من السيارات متوقفة على الشارع.
The Chinese girl was playing the guitar.	رجلان يلعبان الغيتار بينما هم على متن قارب.
The person is hiding under an umbrella.	شخص تحت مظلة.
A woman and her kids are flying kites.	امرأة وأطفالها يطيّرون الطائرات الورقية في المطر.
A man attempts to get good signal inside an internet cafe.	شخص يقوم بمكالمة هاتفية على الرصيف.
Two men learning to use their legs again.	النساء والرجال يستخدمون أيديهم لتقديم وجهة نظرهم.
