A silhouette of two dogs running by a lake.	Çamurda yürüyen, birinin ağzında bir top olan iki siyah ve beyaz köpek.
The lady is blonde.	Kadın sarışın.
People are having a meeting.	İnsanlar bir toplantı yapıyor.
The dog is competing in dog agility	köpek atın üstünden atlıyor
A man taking apples out of a bag on a counter.	Çamaşırhanedeki bir adam, mavi çantasını bir sepetten çıkarmak üzere.
The child is playing in the ocean.	Okyanusta oynayan bir çocuk.
The couple is going to the store.	Adam alışveriş yapmak için mağazaya yürüyor.
Beautiful lights accent trees on a dark night.	Parlak kıyafetler giymiş bir çocuk ağaç salıncağında sallanıyor.
The man is painting.	Adam bir evi boyuyor.
men repair pot hole	İki adam delikler kazıyor.
An old woman is knitting with blue yarn.	Bir kadın kazak örüyor.
3 men are outdoors working.	2 adam dışarıda çalışıyor.
A man is standing still in the street.	Sokakta bir adam var.
A woman is sitting on cloth.	Bir kadın beyaz bir kanepede oturuyor.
A man with a red flag with a bull.	Mavi şapkalı bir adam mavi bir teknede oturuyor.
The firefighters were the first to arrive at the scene.	Kadınlar, sabah şehirden ayrılıyor.
People are in a hot air balloon.	Sıcak hava balonundaki dört insan.
a young girl and a person are climbing up a ladder	Genç kız geniş bir merdivenin üzerinden atlar.
boy eats potato	çocuk patates yer
Boy in trunks on watery pavements while parents look	Kişi, banyo aynasında güzel sarı saçlarını tarıyor.
People are walking through a Christmas themed market.	İnsanlar bir restoranda konuşuyor.
The kids are sleep.	Çocuklar uyuyor.
A young man is playing and singing.	Bir adam grubuyla birlikte şarkı söylüyor.
there is a worried boy over there	Kız vurulmak üzere.
A cowboy doesn't wrangle the calf.	Rodeoda bir danayı zapt etmeye çalışan bir kovboy.
A man is running down a sand covered mountain.	Bir adam kumda yürüyor.
A skateboarder does a trick on concrete.	Bir kaykaycı rampada numara yapar.
It snowed that day.	Bebek, öğleden sonra uykusu için yatırılmıştı.
man with microphone, hair in afro style.	Siyah saçlı bir adam bir enstrüman çalar.
A person got in the way of the picture being taken by stretching their green hand out.	Tüm bunlardan usanmış olan siyahlı kadın ofis kapılarından içeriye dalar.
the little girl swam in the pool	Bir kız havuzda yüzer.
A black dog jumps off the edge into the lake.	Sahildeki bir kız büyük bir kayadan bir eli havada olacak şekilde kuma atlıyor.
a boy has blonde hair.	Bir çocuğun sarı saçları var.
Two men making strange faces while they drink water.	Alkol alırken komik suratlar yapan iki adam.
There are two people in this picture, and they are both inside.	Bu fotoğrafta iki kişi var ve ikisi de dışarıda.
Someone walks on a wall.	Bir kadın telefonla konuşarak sokaktan aşağı yürür.
a skateboarder is surfing.	Sörfçü sörf yapıyor.
A person sits in a small car.	Bir kişi bir arabada oturur.
They are stinky.	Yemek yiyorlar.
Both dogs have a red toy.	Çocukların oyuncak silahları var ve birinin doldurulmuş bir hayvanı var.
A couple men are swimming for a long time.	Havuzda yüzen ve biriyle konuşan bir kişi.
A child is holding a bunch of balloons in front of their face.	Bir kişi yüzünün önünde bir fotoğraf tutuyor.
The grass is red.	Çim yeşil.
A rock climber is falling off of a mountain.	Bir kaya tırmanıcısı dağdan atlıyor.
Two people are looking into the water while a boat passes by.	İki kişi suda bir teknede.
The boat sails past the shore.	Tekne, okyanusa doğru yelken açtı
The man is in a  white shirt	adam siyah bir tişört giymiş
Dogs playing together.	Köpekler beraber oynar.
A man is riding his bike inside.	Bir adam bisiklet sürüyor ve köpeğini gezdiriyor.
The man is running away from people.	Bir adam kızgın insanlardan kaçmak için sahada koşuyor.
Four people are meeting around table in a modern decorated room.	Birkaç kişi karanlıkta bir masanın etrafında
A girl dressed in blue plays outside on a nice lawn.	Mavi gömlekli bir adam izlerken holde oynayan üç küçük çocuk.
A dog gnawing on a camera strap.	Ağzında bir çubukla koşan bir köpek
The young female has a facial expression.	Bir kadının dövmeleri var.
A young boy in a uniform gets the ball from his rival.	bir çocuk ellerinde basket topuyla koşuyor.
A group of people are celebrating a birthday by partying.	Grup, bir doğum gününü kutluyor.
There are numbers written on the stage.	Bu fotoğrafta bir grup bisikletin üstünde birkaç insan var.
The group of people wait to cross the road.	İnsanlar yolun karşısına geçmek için bekliyor.
The man is in a hospital	Bir kız bir hastanede.
The man is waiting for his pizza to be delivered.	Adam, pizzanın teslim edilmesini bekliyor.
The boat has pink yellow and blue sails.	Tekne sarı renkli.
a man on a surfboard holds a stick	Bir adam bir sörf tahtası tutar.
Two sister relax by a pool.	İki kadın ve bir çocuk iskelede ayakta duruyor.
There is a man wearing clothes.	Atkı takan bir kişi var.
The dog is getting some water in his face.	Adam sudan çıkıyor
Some people play music at a concert.	Bir müzik konserindeler.
A man was jumping.	Adam, başka bir adamın üstüne atlıyor.
A man dressed as a clown riding a bicycle in a race.	Kadın kıyafetleri giymiş bir adam bisiklet sürüyor.
A baseball player's team is watching	Bir futbol takımı beysbol izliyor.
A group of boys have on green and blue.	Bir bando takımında çalan bir öğrenci grubu beyaz, yeşil ve altın rengi kıyafetler giymiş.
A man reaches over a blue carpet to grab a snake from the window sill.	Sarı yağmurluklu bir kişi bir kayanın kenarında aşağı bakarak oturuyor
A merchant doesn't have any items for sale.	Adam bazı eşyaları satmaya çalışıyor.
The grass is green.	Çim kırmızı.
The plants are dead	Bitkiler ölü.
Someone is riding a bike at night.	Bir kişi gece bisiklet sürüyor.
The woman in gray is outside.	Kadın karanlıkta dışarıda.
The sleeping child lies on a hospital bed.	Çocuk yatakta uyuyor.
There are people on the balcony.	Balkonda insanlar var.
A man is walking down the sidewalk in front of the colorful building.	Renkli binanın ve köprünün önünde yalnız başına oturan bir adam.
A group of people are in suits and dresses.	Bir grup kadın takım elbise giymiş.
Two people cut some cake.	bir pastayı kesen iki insan.
Child bicycle race	çocuk bisiklet yarışına katılır
Skateboarder doing a trick.	Bisikletle numaralar yapan bir adam.
A child holds a kite and people watch.	Bir adam, bir küçük çocuk grubu için balon hayvanlar yapıyor.
Laundry day for Mike.	Mutfak çalışanları bu geceki yemek servisi için hazırlanıyor.
The people are conversing about the weather	İnsanlar hava hakkında konuşuyor.
a man stands in a white ice cream truck.	Bir adam, bir dondurma kamyonunda ayakta duruyor.
The men are doing this for fun.	Adamlar eğleniyor.
Man shaving with a Gillette razor with a mirror.	Aynanın önünde ayakta durarak tek kullanımlık bir tıraş bıçağıyla boynunu tıraş eden adam.
The large bird is looking for food.	Adam şu an büyük bir mercanın içinde.
the band is eating	Müzik grubu uyuyor.
A dog ran away from home and seems lost out on the streets.	Çocuklar bir yangından kaçar.
The little boy is getting dirty while he climbs on the tree limb.	Küçük kız küçük oğlandan kaçıyor.
A child running into his mother's arms.	Adam, boştaki eliyle bebek arabasını iterek kızını markette taşır.
A human swims under the pool water.	Bir yüzme havuzu suyla dolu.
Nobody is shirtless.	Herkes gömleksiz.
Two white dogs are running in a field with a horse in the background.	İki köpek, çimenlik bir alanda bir çubuk için kavga ediyor, arkada bir göl var.
Hundreds of people are gathered	Bazı insanlar toplandı.
The men on a roller coaster.	Çift, bir hız treninde.
This waffle will be delicious.	Bu restoran yiyecek servis etmez.
A Houston baseball player has caught a ball and is now throwing the ball towards another team member.	Rakip takımın bir üyesi topu yakalamak için uzanırken bir beysbol oyuncusu koşar.
The crowd cheers on the breakdancer as he shows off his dance moves.	Kalabalık onlara tezahürat yaparken grup konser verir.
A man next to a police officer is walking away from another man.	Bir adam iki market torbası taşıyor, yakınındaki direğin yanında komik bir adamın işareti var.
A child is in the middle of a crowd with their hands raised.	Bir kadın ve bir adam kalabalığın ortasında.
Someone is doing something athletic while gesturing.	Bir kişi, başka biri ona bakarken rap yapıyor.
A woman in a pink shirt examines her camera.	Siyah gömlekli bir kadın kamerasına bakar.
He is lost and not aware of what he's doing.	adam, yukarıdan şapkasının nasıl duracağına dair daha iyi bir fikir edineceğini hissediyor.
the boy jump kicks off the dock	Bir çocuğun sıçraması iskeleyi göle düşürür.
A male athlete falls after jumping a hurdle, into water, while people take pictures.	Üç çocuk umumi bir yerde bir adam oturup onları seyrederken zıplama hareketleri yapar.
An older man in a dark shirt is resting his chin on his hand while writing on a newspaper.	Elinde bir yazı olan bir çocuk mağazada ayakta duruyor.
People are sitting on a park bench while there are 3 pictures visible in the foreground.	Üç insan kenarda oturuyor.
A large chorus erupts.	Kocaman bir kalabalık, bir heavy rock grubunun önünde çılgınca dans ediyor.
Two police talk together in the middle of the road.	İki kız yolun ortasında değil.
Two men are using shovels to dig.	İki adam kazmak için el kürekleri kullanıyor.
Several people are standing in front of a stadium.	İki insan bir kalabalığın önünde.
The man is sitting in the park.	Kadın, parkta dinleniyor.
A woman and man on a bench.	Bankta oturan bir adam ve bir kadın.
A couple walks through the rain with their child holding umbrellas.	İnsanlar yanlarından yürürken ellerini çeşmeye sokan iki kız.
People have gathered to watch an event.	İnsanlar bir konseri izlemek için toplandı.
The girl in purple is followed by the girl in pink	Mor mayolu kız, kırmızı gözlüklü kızın ablası.
A tall person in midair.	Süslü bir yüzü olan bir kişi havada.
Adults are watching their children play.	Üç kız yukarı bakıyor.
Two girls are crying because a boy kicked them in the shin.	Oğlan ve kız el ele tutuşuyor.
A man bikes down the street.	Bir adam sokağın aşağısına doğru sürer.
The diver is in the ocean.	Adam, Kuzey Buz Denizi'nde okyanusun ortasında yüzüyor.
People watching an interesting thing.	Üç kişi, bir adamı bir şey yaparken izliyor.
People are sleeping inside.	İçeride insanlar uyuyor.
There are a lot of people riding bikes.	Bazı insanlar yürüyor, oturuyor veya bisiklet sürüyor.
A man is helping a lady put her goods in baskets.	Genç bir adam, çiftçi marketinde eşinin yardımıyla kurabiyelerini satıyor.
A woman who is wearing a vest is on a subway.	Yelek giyen bir adam bir metroda.
A boy is swimming in the ocean on a sunny day.	güneşli bir günde okyanusta sörf yapan bir adam.
A man is in his pajamas watching TV.	Bir adam, koltuğunda oturarak televizyon izliyor.
Two children read in bed.	Anne ve üç çocuğu evde uyuyor.
A bar with signs advertising beers such as Bud Light and Corona.	Kahverengi bira şişesinin adı Winter Hook'tur.
the woman holds something	Adam bir şey tutar.
Three people play cards.	Bazı insanlar bir kart oyunu oynuyor.
A hiker is on the bottom of a hillside.	Bir adam dağın yan tarafına tırmanıyor.
A young man works for a museum.	Genç bir adam ve kadın bir müzede.
A teenage boy jumps into a pool in a tropical locale.	Bir kız havuza dalış yapar.
Two men sitting in a doorway working on something.	Onlarla konuşan elbiseli bir kadına bakan ahşap patikada ayakta duran iki adam.
James likes to pray in church.	Baba ve oğul kilisede.
A man is surfing in the Atlantic Ocean.	Okyanusta sörf yapan bir kişi.
The men shoveled the snow.	Adamlar kürekle kazdı.
The man is riding a hover board through the streets.	Bisikletteki adam sokakta bisiklet sürüyor.
The mosaic workers were commissioned to design the tile floor.	Beyaz ceketli iki mozaik işçisi ayrıntılı bir şekilde tasarlanmış fayans zemin üzerinde çalışır.
There is a man wearing a shirt.	Mavi bir gömlek giyen bir adam var.
Two police officers on scooters turn back towards the camera.	iki atlı polis memuru sokağın aşağısına ilerliyor.
A teacher's assistant grades papers in a coffee shop.	Adam bir mağazada çalışır.
The big dog is chasing a ball.	Küçük köpek bir topu kovalıyor.
The man is holding a tube.	Adam, kadın için mikrofonu tutuyor.
A clown is preparing to do surgery.	Bir bebek, güzel vakit geçiriyor.
The man in a green shirt is waiting for them to deliver his brush shredding machine.	Kırmızı ceketli bir adam bir kağıt parçasını okumaya çalışırken kendini güneşten koruyor.
A man wearing a pink shirt is riding the subway.	Trendeki adam mavi bir gömlek giyiyor
Two dogs, one holding a ball.	İki köpek ve bir top.
The older woman is feeding oranges to the man.	Bir kadın ve oğlan suyun içinde.
Three kids sit and listen to a librarian read a story.	Çocuklar oturur ve bir hikaye dinler.
A guy in a white shirt is holding some wires, and tools.	Beyaz gömlekli bir adam birkaç kablo tutuyor.
There is a man in a beret and a woman in a pink coat.	Siyah paltolu bir adam var.
A group of people cheering for a statue of Barack obama	insanlar bir sancağı tutuyor
A woman sitting in a pool holding a martini with a baby laying next to her.	Bir kadının oturduğu ve yanında bebek arabası bulunan bir piknik masası.
The dogs are walking.	Köpekler oturuyor.
There are boys outdoors.	Dışarıda kızlar var.
A group of ladies in the cold cheer with American flags.	Geçit töreni sırasında bir grup kırmızılı ve beyazlı amigo kız moralimizi yüksek tuttu.
A group of male and female cheerleaders are outside cheering for the football team.	Genç bir arkadaş grubu futbol takımına tezahürat yapıyor.
A couple attempting to establish telephone communications.	Bir kişi, şarj olan bir cep telefonunda e-postasını kontrol ediyor.
A bird flying over a desert.	Bir alana iniş yapan bir kaz sürüsü.
A white dog and a brown dog running across a grassy field.	Çimenlik bir alanda koşan siyah bir köpek ile beyaz ve kahverengi bir köpek
A man is playing a game on his laptop.	Genç bir oğlan, bir oyun konsolunda oynarken bir yüz ifadesi yapar.
Young man attempts to repair wiring job.	Bir adam bilgisayarlarını tamir etmeye çalışıyor.
A statue with with a bit of wear.	Siyah bir şapka giyen ve gözlük takan bir adam elindeki bir nesneye bakıyor.
Man riding a bicycle in New York	New York'ta bisiklet süren adam.
A man in a brown hat is helping a man with no hair up off the ground.	Ceketli ve şapkalı geniş bir adam, bir şeyi kulağına doğru tutuyor.
The man jumps on the ground and dances.	Adam zeminde dans ediyor
A man is sleeping and a clown is in front of him.	Bir adamın önünde bir kız var.
Two bicyclists are running over a hill while carrying their bicycles.	Adamlar, küçük motosikletleriyle toprak yoldalar.
Men are hiking a mountain.	Bir şelalenin yakınında yürüyüş yapan iki kişi.
The sad lady in the blue shirt is waiting to cross the busy street.	Mavi gömlekli bir adam kalabalık sokakta karşıya geçmek için bekliyor.
Some people are in an inflatable raft.	Salda bazı insanlar var.
Friends are partying with e new band	İki çocuk, görüntülü sohbette babalarıyla konuşurken gülümsüyor.
A man is sitting at a table while playing poker.	Bir kadın, kumarhanede masada oturuyor ve yirmi bir oynuyor.
A young boy brushes the teeth of a fake alligator.	Sahte bir timsahın kuyruğuna tutunan bir çocuk.
An old woman is walking by a building with graffiti on it.	Bir kadın bir binanın yanından yürüyor.
boy scouts play a game	bir oğlan beysbol oynuyor
the old man is thinking hard	Yaşlı bir adam bir şey kesiyor.
three sports persons posing for the photo	Üç atlet fotoğraf için poz veriyor
A vehicle is parked.	Dışarıda bir araç park etmiş.
a group of rabbits eat carrots	bir grup köpek marul yer
A group of musicians perform in front of six people.	Tüm grup, bir barda dans ediyor
A line of spectators are betting on the race.	İki koşucu, bir pist yarışının sonunda yorgun.
There is a person ready to compete in a swimming competition.	Bir adam, özel bir havuzda tek başına yüzüyor.
A boy throwing a yellow baseball.	Beyzbol sopası olan, bağıran bir çocuk.
Two men are playing pool for money.	Üç adam havuzda eğleniyor.
A child is holding a trident.	Bir çocuk bir silah tutuyor.
a young man wearing a blue shirt with a strange white building in the background	Mavi gömlek giyen genç bir kadın, evindeki masanın yanında yeşil bir nesne tutuyor.
workers tend to a transit stop	İnsanlar bir trenin gelmesini bekliyor.
A boy is in a tree.	Ağaçta kalan bir çocuk.
A man is reading a news article.	Bir kadın bir gazete okuyor.
Working all night.	Üç köpek birbirlerinin en iyi arkadaşıdır ve her gün birlikte koşup oynarlar.
Women in a sewing factory with red fabric.	İki kadın fabrikada kıyafet dikiyor.
An Asian woman waiting for the show to begin.	İnsanlar gösteri için beklenti halindeler.
A man is standing on the rocky ground in front of the mountain.	Adam, okyanusun önünde durur.
A woman on a beach at sunset is suspended in the air.	Bir çocuk, sahilde havaya atıldı.
kayaker feel happy	Kimse ağlamıyor
The old man and the sea are part of this scene.	Adam ve çocuk çölde ayakta duruyor.
People and a dresser are waiting at a bus stop in front of a brick building.	Çok az insanın olduğu bir sokakta bulunan ve kapısının yanında bir bisiklet olan kırmızı tuğlalı bina.
The surfers are wearing wetsuits.	Şort mayo giyiyorlar.
A couple of men are sailing a boat.	Birkaç erkek kayığın küreklerini çekiyor.
The people are really aliens.	İnsanlar bir şey arıyor.
The man is sleeping during his job	İşten sonra dinlenen bir adam.
the train tracks are broken	Tren rayları ahşap.
A blond woman with a pink shirt and black leather pants holds a camera on a running track.	Sahneyi kuran siyah ceket ve kot pantolon giyen bir adam.
A baby crawling all over their father excitedly.	İki çocuk ellerini bir araya getirir ve başka bir çocuk ellerinin altından geçer.
A snowboarder in green grinds along the edge of a rail at night.	Yeşil bir bisikletteki yeşil giymiş bir adam rampadan atladıktan sonra havada.
Two kids cleaning up their room	Çocuklar temizlik yapıyor
A little girl is playing with some dough.	Küçük bir kız bir su topuyla oynar ve kahkaha atar.
on of the boys is performing an ollie	Çocuk, çeşmede oynuyor.
People walk down a street during a sunny day.	Güneşli bir günde sokakta yürüyen insanlar.
Workers are busy at their job.	İşçiler, işlerini yapmak üzere gece dışarıdalar.
A young Asian boy is waving a sparkler around at night.	Bir adam ve bir kadın evde bir geçit törenini izliyor
A man in a suit by a stoplight.	Trafik lambasının yanında mavi takım elbiseli bir adam.
The musicians are practicing in an empty room.	Müzisyenler, özel bir odada alıştırma yapıyor.
The young boy reaching for the baton from the girl as he runs the relay race.	Çocuk ilk defa sörf yaptı.
Two peope are sitting outdoors.	Dışarıda yürüyen üç adam var
An art gallery is being set up.	Bir adam, sanat galerisi için resim yapıyor.
An accident between two automobiles has grabbed people's attention.	Kazaya iki araba karıştı.
The leotard is red.	Şapka beyaz.
A boy is being chased through a toy tunnel by a dog.	Çocuk bir köpek tarafından kovalanıyor.
A windsurfer dressed in teal is on his boogie board.	Mohawk stili saç kesimi ve sörfçü şortu olan bir adam sahilde yarım sörf tahtasında duruyor.
a person is with a cute child	Bir adam, sevimli bir çocuğu olan bir kadın.
Two people look up towards a gold statue.	İki çocuk bir heykelin eline tırmanıyor.
People making music together	Birlikte müzik yapan insanlar.
A photographer takes pictures of a family that includes four children and two parents	Bir anne ve iki çocuğu aile fotoğrafı çekiyor.
Some men doing volunteer work at the park.	Adamlar işteler.
A man imitates Superman.	Adam, bir örümcek adam kostümü giyiyor
A boy is relaxing on the beach.	Bir oğlan sahilde yürüyor.
A group of people are waiting to see a rock concert.	Bir grup insan bir müzik grubunun performansını izliyor.
Motorcyclists taking a break.	Mola veren iki bisikletçi.
A competitive runner taking her first sprint in a competition.	Atlet, uzun atlama karşılaşmasında yarışıyor.
A boy is wearing an all black outfit.	Bir atın üzerindeki siyahlı ve sarılı bir adam, kırmızı giyen bir kişiyle konuşuyor.
The woman is wearing a ballcap.	Kız, bir beysbol şapkası takıyor.
The construction workers appear through a wooden fence.	sokak tabelasının arkasındaki kısmen inşa edilmiş bir binada duran birkaç işçi
lady and man sitting on couch reading in sweats	Kanepede uyuyan pijamalı genç bir oğlan.
A rock climber with a white helmet is repelling.	Beyaz kasklı bir kişi kayalara tırmanıyor.
People strolling casually across a bridge.	İki kişi terk edilen sokakta gelişigüzel yürür.
A man in a khaki colored uniform carries a brunette woman in white clothing on his shoulder.	Kırmızı gömlekli bir kadın, kendisinden daha genç olan beyaz gömlekli bir kadını mavi bir mata iliştiriyor.
A coach smiles at a player.	Bir koç, oyuncularıyla birlikte kenarda durur.
Six women wearing black jackets and bright red boas smile at the camera.	Sarı gömlekli üç kadın kameraya gülümsüyor.
There are 70 participants on each team on the field.	Sahada iki takım var.
A large family poses for a photo.	Fotoğraf çeken bir aile var
A girl is inspecting a machine.	Bir kadın bir makineyle çalışıyor.
A brown dog not wading	Suda yürüyen kahverengi bir köpek
A person is riding his bike on a sunny day.	Bir adam güneşli bir günde bisiklet sürüyor.
A young man wearing a red bracelet scratching his head.	Başını eğen şapkalı genç adam.
A brown dog loves the water and splashing around.	Suda su sıçratan siyah bir köpek var.
The jogger is sitting in the park.	Adam parkta oturuyor.
His is in a competition.	Kadın bir yarışmada.
A lady is climbing a mountain.	Bir aile dağa tırmanıyor.
A girl reads on a crowded beach.	Bir kız sahilde yürüyor.
The black dog is running in the water near the shore.	Beyaz köpek sahilde gelen dalganın suları arasında yürüyor.
A closeup of two women wearing bags on their heads.	Güneş gözlüğü takan iki adam, ikisi için ikişer birayla bir masada oturuyor.
A young child is on a playground riding the swing.	Bir oğlan ve bir kız parktaki bir salıncakta sallanıyor.
There are some shoes in the child's hands.	Çocukların elleri boş.
A man is showing off a picture.	Bir adam gösteriş yapıyor.
A roller skater does various tricks off a ramp.	Bir kadın, rampanın aşağısında paten numaraları yapıyor.
Brothers playing outside	İki erkek kardeş dışarıda oynuyor.
A skateboarder is entertaining a crowd.	Bir kalabalığı eğlendiren bir sanatçı.
A man watching a ball in the air.	Bir adam, sahilde kahverengi bir köpeğin yakalaması için bir topu havada tutar.
There is a young person next to a tree.	Ağacın yanında bir kişi var.
The man is losing a sumo wrestling match in the middle of the street.	Adam bir güreş turnuvasında.
People are passing protesters as they go about their buisness.	İki kişi birbiriyle konuşuyor.
THe artist is packing up is painting tools	Beyefendi tuval ve şövale kullanıyor.
These people are going to buy some materials for pho.	Bazı insanlar satmak için el işi yapıyor.
A man with a long beard playing a guitar.	Uzun saçlı bir adam gitar çalar.
The woman is on a trolley.	Kadın bir otobüste.
the boy holds a snake	çocuk içeride bir kedi tutar
Bagpipers march down a street.	Bir adam gece sokakta düştü
Six men and women jumping up on a beach.	İki kadın plajda yukarı aşağı zıplıyor.
A man is changing around the furniture in his room for a party.	Bir işletmedeki bir adam gözlüğü yere düştüğünde sinirleniyor.
Two dogs are play with a ball.	iki köpek bir topla oynuyor.
Young people are engaged in a game.	Bir oyuna iki kişi dahil.
The man is examining an object.	Kadın, bir adama bir nesneyi gösteriyor.
A man in a suit with his tie flying walks down the sidewalk.	Takım elbiseli bir adam uzun gölgeli bir binadan yürüyerek uzaklaşır.
The men wearing opposing jerseys are getting in a fist fight	Yumuşak kask takan iki genç adam bir hakemin yanında güreşiyor.
The doctor is by himself in his office.	Çocuk, bir kütüphanede babası tarafından tutuluyor.
A brown and tan dog walks through the green grass.	Beyaz ve esmer renkli bir köpek uzun yeşil çimlerin arasından koşar.
A man is taking pictures at a dance festival.	Adam, bir festivalde dans ediyor.
The two children love each other.	Çift birbirini seviyor.
The woman crosses the street empty-handed.	Kız sokaktan aşağı yürüyor
The two men are deciding which fish they want.	Köpekler birbirine yakın değil.
A protest or parade against oil spills.	Eylem esnasında mola vermek.
A model is posing for the cameras.	Bir model kameraya poz verir.
a man watches wresting match	Raketiyle tenis topuna vurmak için sıçrayan bir çocuk
At a supermarket, people are buying their groceries.	İşlek üretim pazarında birçok insan alışveriş yapar ve satar.
two men are dressed	Dört adam giyindi
A cowboy riding a horse.	kovboy bir ata biniyor
A worker is destroying an artist's work.	İşçi, bir heykel yapıyor.
A artist is not at work	Sanatçı, işte.
Three girls in white dresses run toward a fountain in a park.	Bir çeşmeye doğru koşan beyaz elbiseli üç kız.
The woman has a pie.	Kadın, bir turta yapıyor.
The young children listen to the teacher.	Çocuklar sınıfta oturur ve öğretmeni dinler.
A man stands in the distance on the ocean while he stands on a small boat.	Kıyıda suyun içinde yürüyen bir adam.
Kids run in a field.	Bir köpek yazlık alanda koşar.
a man is protesting something	Bir adam protesto ediyor.
A large black dog is jumping off a pier into a pond.	Siyah bir köpek bir iskeleden göle atlar.
The group of people have stuck in the cellar since the earthquake buried the house.	İnsanlar bodrumda.
A young man is holding onto a casserole dish with pot holders.	Bir adam ayakta duruyor ve donmuş bir tatlı tutuyor.
Men are lying down.	İnsanlar uzanıyor.
A group of people standing under an umbrella at a coffee table.	Mutfakta ayakta duran bir grup insan.
A man in a hat and glasses looks through a telescope during the night while the stars are out.	adam bir teleskopla şehre bakar
The other woman is wearing a leather jacket.	Adam deri bir ceket giyiyor.
the people are bored	insanlar korkuyor
The man is in bed asleep.	Adam yatakta uyuyor.
A man is drawing graffiti on the side of a gray wall.	Taş bir duvarın önünde bir ağın üstünde çalışan gri ceketli ve mavi kot pantolonlu bir adam.
A street vendor is with his cart.	Bir adamın eli alışveriş arabasında.
A dog bites an arm.	Bir köpek diğer köpeğin kulağını ısırır.
A stewardess is on a plane.	Pilot kıyafetli bir adam uçaktan iniyor.
No one has won any prizes today.	Burada gösterilen bir kişiden fazla kişi var.
Two female are walking their dogs, and the male is interested in the dogs.	İki köpek ve bir kadın var.
A man wearing black shirt with devil looking eyes, holding two big slices of meat.	Gri saçlı ve kırmızı şapkalı bir adam dışarıda ayakta duruyor.
A woman is carrying her daughter.	Bir anne çocuğunu taşıyor.
There is a clown making audience members laugh.	Bir izleyici, sarı kıyafetli insanların performansını izliyor.
A couple on the side of the road talking about deep things.	Bir arazide yanında büyük bir ağaç bulunan bir eve doğru yürüyen birkaç insan var.
The white banner is behind the people sitting down.	İnsanlar, beyaz bir sancağın önünde oturuyor.
One man is running through the house with his dog.	Adam evinden dışarı yürüyor.
A young girl smiles for the camera.	genç bir kız ve bir kadın kameraya gülümser.
A group of people are standing together outside.	Dışarıda duran bir grup insan.
Someone in a red coat and white helmet skis past some trees.	Karın üzerinden atlayan esmer lekeli beyaz köpek, arkasında beyaz ve siyah köpeğin olduğu nesnenin önünü kapattı.
People are in a tent by a wall.	Bir insan kitlesi kapalı bir çadırın önünde.
Badgers burrow into their hole	Adamlar bir deliğe kürekle toprak atıyor
A young boy with a painted face plays on the pavement.	Kırmızı, beyaz ve mavimsi gri kıyafetler giyen yaşlı bir adam, müzik yapmak için bir testere kullanıyor.
A person on a bike and wearing a helmet rides through a  area.	Sert bir şapka giyen biri sokakta bisiklet sürer.
A person is walking their cat.	Bir adam köpeğini gezdiriyor.
The bicyclists are riding to the book store.	Sarı taksi ve bisiklet aynı mağazaya gidiyor.
An older man and a younger man are wearing jackets.	Bir kadına sarılan bir erkek, ikisi de kırmızı kıyafetler giyiyor.
The couple are asleep.	Kanepede uyuyorlar.
People are on the beach with animals.	Hayvanlar sahilde.
There are people sleeping at the park.	Parkta insanlar uyuyor.
The guy is about to get into his car.	Adam arabasına ulaşmaya çalışıyor.
Three men are pouring cement.	Üç adam ellerini yıkıyor.
A man with green shoes is jumping to catch a frisbee.	Yeşil ayakkabılı bir kişi bir frizbiyi yakalamak için sıçrıyor.
Two people are wearing shirts.	Gömlek giyen üç insan var.
A woman and man are talking while another woman leans on her car biting her nails.	Bir adam, cep telefonunu kullanan genç bir kadına bakarak elleri ceplerinde ayakta duruyor.
A cat is climbing a tree.	Kız, bir ağaca tırmanıyor.
A guy running on a pretty day on the dock.	Sahilde geri takla atan bir adam.
A cowboy riding a horse at a rodeo with 8 seconds on the clock.	Bir at ve binici bir yarışta sıçrıyor.
A man shoots pool while another waits for their turn	Bir adam, seyirciler izlerken havuzun içine ters takla atar.
a man is holding books	Bir kadın bir kitap tutuyor.
A man wearing an orange shirt and blue hard hat is measuring an area.	Adam, koyu kırmızı bir gömlek giyiyor.
A young man and woman at a dining table.	Bir yemek masasında yaşlı bir adam ve kadın.
A mother is pushing her child is a stroller.	Bir kadın bebek bakıcılığı yapıyor.
A girl in a gray shirt and brown hair relaxes on the lawn as dogs bound around her.	Siyah pantolon ve gri gömlek giyen çocuk, babası için ineği kurulamak zorunda.
two people wrestle	Beş kişi, iki kişinin güreşmesini izliyor.
The shirt is solid	Hakem, koyu siyah bir bayrak tutuyor.
The item is wrapped in paper.	Bir masanın üzerinde bir parça kağıt var.
The men are sitting on the patio.	Adamlar kaldırımda oturuyor
a large white puddle running along with a pink flip-flop in its mouth	Küçük kahverengi ve beyaz köpek, güneş ışığının vurduğu kırmızı bir kilimde yatar.
Two women in dresses are getting on a bus.	İki kadın da bir otobüste oturuyor.
The man lost his prosthetic leg.	Kadının güzel bacakları var.
People sit on a subway train that goes Downtown.	Bir otobüs durağında bekleyen insanlar.
Collie dog races around a pole.	Bir dağ bisikletçisi virajı hızlıca geçer.
A person climbs rocks.	bir adam büyük kayalara tırmanır.
A group of friends together listing to U2.	Bir arkadaş grubu birlikte.
the children watch the tv	Çocuk televizyon izledi.
The guys are waiting for a game to begin.	Bir oyunun başlamasını bekliyorlar.
The player is wearing a uniform.	Beyzbol oyuncusu bir forma giyiyor.
Three sisters wearing dresses stand outside.	Elbise giyen üç kadın dışarıda duruyor.
A woman in a yellow tank top is looking at a window.	Bir adam, odada bir merdivende duruyor.
A woman videotapes an event in the tent.	Beyaz gömlekli bir kadın çadırdaki bir olayı kameraya çeker.
The boy is jumping off the diving board.	Adam, tramplenden atlıyor.
There's a woman with a camera among several other women in the area.	Dışarıda birkaç adam var, birinin kamerası var.
Some men are being given an interview.	İki adam bir tartışma sırasında hiçbir şey söylemiyor.
A boy wearing a red sweatshirt is raking a pile of leaves.	Kırmızı kazaklı bir oğlan yaprakları tırmıkla yığın haline getirir.
Two rich children are at daycare playing on the carpet.	İki çocuk evde kendi odalarında birlikte oynuyor.
There is a very frustrated man in the photograph.	Bu fotoğrafta dışarıda bir adam var.
A man is inside trying on glasses.	Bir camdan dışarı bakan gömleksiz bir adam.
The kid skateboards straight down the sidewalk.	Oğlan, kaldırımda paten kayar.
The dog is sleeping near the pool	Bir köpek suyun yakınında uyuyor.
A man is outside in a city.	Bir adam bir şehirde yürüyor.
The camera is on the floor.	Sokakta bir kamera var.
A man is driving by the exhibition hall in a small yellow car.	Bir alışveriş merkezinde bir adam ve bir bisikletin altın heykeli sergileniyor.
A man in a white t-shirt holding a cellphone is standing on a street corner.	Siyah şapkalı bir adam bir sokak lambasının yanında duruyor.
Two men are holding weapons.	Silahlı iki adam.
There is a war reenactment among friends.	Çocuklar, iç savaş canlandırması yapıyor.
Man waits for taxis to pass before crossing the wet road.	Köpek, ıslak yolu geçmeden önce taksilerin geçmesini bekler.
A girl is sleeping in a bunk bed.	Bir oğlan bir yatakta uyuyor.
people eat upstairs while man below unpacks	insanlar üstünde yemek yerken adam kutuları açar
Man sitting on bench next to bike.	Kampçı, sırt çantasının yanında oturuyor.
A man is looking at ducks hanging through a window of an ethnic food store.	Bir adam bir mağazanın dışında camdan satılık yiyeceklere bakıyor.
Dogs crossing a lake using a footbridge.	Bir çitin yakınındaki yolda bisiklet süren bir kişi.
An old couple has just gotten engaged.	Bir çift yeni nişanlandı.
a shirtless boy sleeps on a couch	kanepedeki çocuk
A girl is with a snowman.	Bir adam yavru bir köpekle beraber.
The older man has a younger fashion sense than the younger man.	Yaşlı bir adam, genç bir kadınla konuşuyor.
A man jumps over his friend to avoid waking him.	Bir kadın, oğlunu güldürmek için onu havuza atar.
The man is walking to pick stone.	Tüm insanların nereye gittiğini merak ederek sokakta yürüyen tek bir kişi var.
A couple are at the beach.	Sahilde birkaç insan var.
a guy rides his bike to the metro	Bir adam otoparkta bisikletini sürer.
A woman with a suitcase takes a break at the park bench.	Bir adam parkta bir bankta oturuyor.
The men feel the cold.	Adamlar sıcak hisseder.
A police officer keeps watch a parade.	Bir polis memuru geçit törenindeki herkesi izliyor.
A group of young women compete in the triathlon.	Bir grup kız bir paten turnuvasına katılıyor.
A woman in a black coat looks at a window display of bread.	Siyah elbiseli bir kadın bir eşya masasının önünde oturur.
A girl is eating cereal straight out of the box.	Oğlan, bir turtanın yarısını yiyor.
A blond woman walking a plaza in front of brightly colored buildings.	parlak binaların önünde sarışın bir kadın
Two men on mopeds drive down the street.	Motorlu bisikletteki iki Asyalı adam sokağın aşağısına doğru sürer.
There are many boys.	Dışarıda üç hayvan var.
The man is using tools.	Bir adam ve bir çocuk teleskopla bir şey izliyor.
Two children playing on an orange jungle gym in the winter time.	İki genç kız sıcak yaz güneşinde fıskiyelerin arasında oynar.
Three men are happy.	İki adam eğleniyor.
Asian women hold a young girl.	Genç bir adam izlerken yemek hazırlayan iki Asyalı kadın.
A woman dressed in white hitting a tennis ball.	Mavi gömlekli, beyaz şortlu genç bir kadın bir tenis topuna vurur.
The street is deserted.	Sokak kalabalık.
Three men are standing on a ledge and no one smokes.	Birkaç adam ayaklarının üzerinde.
A man is driving down the street as two cars are passing by going the opposite direction.	Bir yolun aşağısına süren bu aracın dışında sarkan insanlar var.
There are three people on grass.	İki kişi çimlerde sevişiyor.
A large white pipe is being lowered on a trailer, as two workers stand by.	Tahta kalaslarla desteklenmiş büyük bir kayanın üstünde çalışan mavi kazaklı bir kişi.
Two older men are having a discussion outdoors in an area with stone walls and floor.	Üç kadın zemininde kum olan açık, taş binada yürüyor.
A sweat shop is in full spring.	Yeşil gömlekli adam, kamp ateşinde ailesi için yemek pişiriyor.
The toddler is walking next to the pram.	Kepenkli kapı, kadının yanında.
A woman cooks on the stove in her kitchen as her dog begs below.	Genç bir kadın mutfağında yemek yapıyor.
A cyclist rushes through the air	Bir bisiklet havaya sıçrıyor.
They are relaxing in front of the television.	Bir grup insan yeni film için sırada bekliyor.
A guy is riding a moped.	Bir adam bir bisiklete biniyor.
Two people, a man and a woman, are looking at a structure being burned down.	İki kişi var, bir adam ve bir oğlan.
A man in an elephant costume plays the electric keyboard.	Tişörtlü bir adam klavye çalıyor.
The fisherman is waiting on help to fix the net.	Adam, kütükleri kesmek amacıyla testereyi kullanmak için çok çalışıyor.
Willie Nelson looking stage right while at the microphone.	Dışarıda gün batımında davul çalan bir adam ve onun arkasında oturmuş gitar çalan bir adam.
Three guys and one woman sitting in chairs looking attentively to the right.	Adam ve kız sandalyede otururken birbirlerine neşeyle bakıyor.
A man with a handicap was in a wheelchair race and won.	bir koşucu ilk yarışında koşuyor
The man and child are in their swim gear walking by billboards.	İki kadın mavi binanın yanında köpeklerini gezdiriyor.
Two groups of children are playing soccer.	Bir grup genç futbol oynuyor.
Three sheep graze on the grassy field with a dog walking behind them.	iki köpek, koyunların olduğu bir alanda yürüyor.
A fisherman is sorting through the caught fish.	Bir köpek, bir balığı yakalamak için suda koşar.
The vest is dark.	Oda karanlık
A little girl in pink sits quietly reading a book.	kadın, küçük oğlana bir hikaye okuyor
Little boy having lunch in a cafe	bir restoranda yemek yiyen adam
people are skateboarding	İnsanlar kaykaya biniyor.
A young person is working in the yard.	Bir adam işte.
A girl is sleeping in her bedroom.	Kadın, yatak odasında uyuyor.
A woman helps a child.	Bir kadın çocuğu iter.
The janitor shines the floors.	Biri yeri siliyor.
Some people are engaging in activities.	Birkaç genç farklı aktivitelerle uğraşıyor.
Two teams of male sports players are huddled together on a field covered in mud with photographers looking on.	Arkada birkaç insan ve çadırlar varken açık çimenlik bir alanda frizbi oynayan dört adam.
Clown smiles at people.	Süpürge tutan palyaço insanlara gülümser.
A young girl hangs from a basketball hoop while a boy stands underneath.	Beyaz ve mor kıyafetli kırmızı saçlı bir kadın, kırmızı spor bir arabanın yanından geçer.
A woman in pajamas hangs laundry on a clothesline.	Banyoyu temizleyen bir kadın.
A parade of people wearing red march past a building while playing instruments.	Tamamen siyah giyinmiş iki kişi, arka planda şehir varken mavi bir duvarın yanında duruyor.
A child is rolling blading down a path on Venice Beach.	Bir kişi bisikletle bir bahçede gezinir.
A person giving directions to a crowd of younger people.	Bir adam ve bir kadın arkalarından konuşurken bir grup insan hoparlörü dinliyor gibi görünüyor.
These people are fishing	insanlar balık tutuyor
The man is conducting an interview for Fox News	Grup, kuliste bir haber muhabirine röportaj veriyor.
three women are exploring	Üç kadın birlikte
the man read alone outside	Adam, insanları soymak için bekliyor
The kids are splashing water everywhere.	Küçük çocuklar kendi aralarında su sıçratıyor.
Two people are cruising down the road on their bikes.	Üç kişi, açık yolda motosikletlerini sürüyor.
A young girl squishes her face in a smile for the camera.	genç bir kız ve bir kadın kameraya gülümser.
A surfer walking into the ocean	Bir sörfçü okyanusta kürek çeker.
A man and his pet are outside.	Bir oğlan ve köpeği dışarıda.
The woman in the blue top is holding a pink jacket in her arms	Kadın, mavi bir ceket giymiş.
The man and woman are in different rooms.	Kadın ve adam birbirlerine yakınlar.
Two people shake hands under a sign.	Bir grup insan ellerini kavuşturmuş şekilde oturuyor.
A football fan is at a football game in a stadium.	Kalabalık bir grup bir Birmingham futbol maçında.
A horse is running fast.	At hızlı koşuyor.
The passengers are riding in the trailer connected to the tractor.	İnsanlar traktöre biniyor.
A group of young people hang out in the evening.	Bir grup insan bir partide oturur.
A woman in a blue shirt is typing on a laptop computer.	telefon kulübesini kullanan siyah takım elbiseli bir adam.
A girl floating in the ocean on a beautiful day.	bir kız okyanusta yürür.
A person and a horse are wearing things.	Bir türbandan başka hiçbir şey giymeyen koyu tenli bir kadın çamaşır yıkayarak suda duruyor.
A man at a costume party is serving drinks.	Bir adam ve bir kadın bir barda Cadılar Bayramı partisine katılıyor
A person is shopping.	Kişi alışveriş yapıyor.
Two people are skiing down a mountain.	Bir dağdan aşağı kayan birçok insan var.
People watching Jaws at the movie theater.	Sinemada oturan insanlar.
Two people are waiting for a job interview.	Muhabirler, bir huzurevindeki insanlarla röportaj yapıyor.
A cat is playing with string in a window.	Bir adam, bir gitarla sahnede.
A group of people stand on the beach.	Bir grup insan sahilde oturuyor.
Two people are canoeing.	Üç kişi kano kullanıyor.
A young man tries a game out at the store.	Bir kız, bir bowling maçında birini yenmeye çalışıyor.
A roller coaster has gone half way across the loop.	Hız treni, bir kıvrımdan geçiyor ve insanları ters döndürüyor.
Woman opening her purse in a Canadian bakery.	Fırındaki bir kadın cüzdanını açar.
A photoshoot for a popular band.	Şarkıcının yakın mesafeden fotoğrafı çekilirken konser veren bir grup.
A couple and their child enjoy a day at the beach.	Anne ve kızı sahilde bir günün tadını çıkarıyor.
Some people in the military are playing ball.	Bu fotoğrafta iki adam var ve ikisi de dışarıda bir oyun oynuyor.
They are both dachshunds.	Hepsi iş arkadaşı.
A snowboarder is performing a jump whilst riding on a pink snowboard at the end of the season.	Sıçrama sırasında snowboard'daki mavili kişi.
Two workers, one lying down and the other sitting in a chair, take a break outside.	Bir çite tutunan, arkalarında su olan biri tulum giymiş iki kız.
Three butterfly swimmers in a pool, coming towards the viewer.	İki kadın, bir şelalenin dibinde bir havuzda yüzer.
A man is climbing a tree.	Bir adam bir ağaca tırmanıyor
The boy is looking at bugs.	Çocuk, bir kediye bakıyor.
A brown dog shakes off water after exiting a natural pond.	Ağzında bir çubukla derin suda yüzen büyük kahverengi bir köpek.
A younger male is not sitting on a chair.	Bir adam ve bir kadın bir masada konuşarak oturuyor.
The children are eating dinner	Yetişkinler yemek yiyor.
People lean together.	İnsanlar beraber vakit geçiriyor.
The man is having a meeting.	Kenar çizgisinde bir adam var.
A mother and daughter are drinking coffee at the kitchen table.	Bir anne ve oğulları, bir alışveriş merkezinin yemek bölümünde pretzel yiyor.
Hitler dressed as a goalie attempts to re-enact his favorite soccer game.	Bir genç, diğer takımın dikkatini dağıtarak kazanmasını engellemek için trompetini çalar.
A girl is standing on the rails of a boardwalk, fishing.	Bir kadın küçük bir çocukla dışarıda şemsiye tarafından korunarak yağmurda yürüyor
People at an outside bar, drinking.	Bir grup genç insan şehirdeki bir kafede oturuyor ve sohbet ediyor.
the people are observing	İnsanlar sessizce gözlemliyor.
A man is crying while other man sits	Bir adam ve kadın oturuyor
A group of men and women who are looking at art in a art show.	Genç kadın, mücevher mağazasında.
